GEOID,2010 Total Population,2010 White Population,2010 African American Population,2010 Asian Population,2010 Other Races Population,2010 Hispanic Population,2010 Total Households,2010 Occupied Households,2010 Vacant Households,2000 Total Population,2000 White Population,2000 African American Population,2000 Asian Population,2000 Other Races Population,2000 Total Housing Units,2000 Occupied Housing Units,2000 Vacant Housing Units,2000 Hispanic Population
3.9041E+11,1277,1209,25,5,38,18,576,539,37,1381,1316,30,8,27,573,547,26,9
3.9041E+11,1721,1613,50,19,39,32,822,724,98,1716,1638,17,16,45,799,735,64,35
3.9041E+11,2258,1896,156,129,77,63,449,397,52,2579,2305,157,66,51,447,414,33,42
3.9041E+11,859,819,19,1,20,16,414,373,41,800,777,5,2,16,340,320,20,2
3.9041E+11,1002,953,18,3,28,24,454,423,31,1085,1038,13,1,33,443,425,18,13
3.9041E+11,2692,2446,127,30,89,82,951,932,19,1180,1137,23,9,11,524,439,85,17
3.9041E+11,927,834,43,1,49,33,369,345,24,898,838,18,4,38,391,346,45,7
3.9041E+11,556,549,0,0,7,5,261,249,12,534,518,3,3,10,261,256,5,5
3.9041E+11,2370,2181,87,17,85,59,918,868,50,2113,2000,57,22,34,803,776,27,22
3.9041E+11,2182,2059,66,2,55,44,1117,970,147,1203,1154,21,7,21,512,477,35,4
3.9041E+11,2374,2157,101,45,71,38,933,885,48,163,156,1,1,5,61,60,1,1
3.9041E+11,772,717,26,7,22,6,358,340,18,742,701,9,13,19,349,339,10,6
3.9041E+11,2556,2379,96,19,62,51,1026,995,31,2325,2141,82,32,70,937,890,47,28
3.9041E+11,229,217,3,2,7,3,107,98,9,218,211,0,0,7,102,98,4,4
3.9041E+11,2742,2509,103,27,103,46,1080,1019,61,2321,2147,89,16,69,911,885,26,17
3.9041E+11,2244,2053,80,31,80,53,952,906,46,373,360,13,0,0,117,117,0,1
3.9041E+11,1601,1396,131,4,70,59,658,626,32,1708,1526,128,2,52,657,626,31,18
3.9041E+11,1616,1269,204,7,136,115,759,708,51,1518,1207,240,13,58,700,656,44,36
3.9041E+11,1190,1178,8,1,3,12,445,431,14,968,936,11,11,10,352,337,15,4
3.9041E+11,1707,1667,6,3,31,26,703,643,60,1585,1538,18,1,28,640,596,44,13
3.9041E+11,2485,2411,5,19,50,35,935,906,29,2008,1965,8,10,25,728,704,24,13
3.9041E+11,2432,2380,16,8,28,25,897,868,29,2104,2079,6,2,17,727,705,22,7
3.9041E+11,2395,2270,33,8,84,39,1077,1006,71,2134,2068,39,5,22,1018,919,99,9
3.9041E+11,881,853,11,6,11,7,344,333,11,846,833,4,0,9,319,308,11,2
3.9041E+11,1108,1004,34,46,24,11,451,420,31,1000,959,23,9,9,391,373,18,15
3.9041E+11,1793,1667,27,58,41,12,707,664,43,1947,1854,23,51,19,698,675,23,7
3.9041E+11,2859,2500,152,156,51,43,968,911,57,2085,1868,166,24,27,650,619,31,29
3.9041E+11,1658,1543,15,76,24,33,565,532,33,1203,1170,1,23,9,362,349,13,16
3.9041E+11,1285,1168,29,60,28,20,512,487,25,115,115,0,0,0,46,45,1,1
3.9041E+11,2842,2565,26,185,66,53,984,928,56,135,126,8,1,0,53,47,6,0
3.9041E+11,1163,1095,11,22,35,9,474,448,26,1030,1017,1,2,10,405,387,18,2
3.9041E+11,1285,1225,15,19,26,19,526,490,36,1271,1189,70,2,10,441,422,19,10
3.9041E+11,1912,1640,46,171,55,40,648,632,16,1101,1032,2,52,15,346,339,7,9
3.9041E+11,1676,1580,17,55,24,24,551,538,13,1719,1650,18,37,14,530,522,8,20
3.9041E+11,1303,1166,23,85,29,29,475,451,24,1044,946,17,58,23,349,334,15,9
3.9041E+11,1894,1643,29,193,29,28,629,606,23,745,688,15,26,16,284,270,14,8
3.9041E+11,2551,2398,43,74,36,25,912,863,49,2422,2281,48,69,24,784,763,21,28
3.9041E+11,2831,2603,58,122,48,32,881,853,28,1935,1832,36,56,11,583,570,13,23
3.9041E+11,961,872,11,38,40,19,339,314,25,597,579,10,7,1,228,215,13,0
3.9041E+11,1317,1146,60,51,60,89,804,745,59,1048,956,19,56,17,677,613,64,15
3.9041E+11,1490,1309,22,132,27,30,550,506,44,978,916,15,39,8,363,331,32,9
3.9041E+11,2588,2441,47,55,45,39,1075,1034,41,2149,2037,30,45,37,786,761,25,21
3.9041E+11,980,624,157,85,114,104,477,416,61,689,417,207,11,54,275,248,27,36
3.9041E+11,2354,1833,154,278,89,86,916,859,57,1950,1728,62,102,58,810,762,48,48
3.9041E+11,1258,1018,51,146,43,29,380,374,6,563,527,15,16,5,200,193,7,4
3.9041E+11,1733,1573,56,60,44,44,627,596,31,1220,1170,20,18,12,424,405,19,13
3.9041E+11,2067,1632,94,281,60,30,687,666,21,431,381,14,16,20,250,157,93,3
3.9041E+11,1747,1434,55,220,38,36,539,532,7,303,260,10,27,6,114,109,5,5
3.9041E+11,3562,2728,195,523,116,82,1061,1038,23,394,379,10,4,1,175,126,49,3
3.9041E+11,1710,1521,40,96,53,31,684,607,77,643,619,3,13,8,241,232,9,2
3.9041E+11,2984,2668,77,82,157,174,1065,994,71,1609,1564,18,17,10,658,619,39,6
3.9041E+11,3558,3156,90,257,55,61,1103,1062,41,1649,1568,30,35,16,531,506,25,8
3.9041E+11,2337,2163,58,67,49,51,793,755,38,1443,1390,26,7,20,487,468,19,6
3.9041E+11,2161,1984,73,52,52,32,644,628,16,716,679,15,6,16,232,228,4,5
3.9041E+11,2226,1824,117,202,83,90,1055,998,57,2043,1845,69,65,64,1003,967,36,48
3.9041E+11,2287,1739,149,296,103,92,1011,969,42,424,390,10,16,8,364,230,134,8
3.9041E+11,2846,2720,23,30,73,33,1081,1013,68,2214,2185,3,11,15,841,806,35,16
3.9041E+11,2343,2190,45,53,55,56,927,863,64,889,865,0,7,17,353,334,19,8
3.9041E+11,2211,1951,113,94,53,55,713,704,9,2264,2049,74,77,64,665,643,22,23
3.9041E+11,1738,1588,77,53,20,31,798,756,42,1605,1496,65,18,26,623,592,31,20
3.9041E+11,2421,2099,157,95,70,59,869,823,46,1607,1485,65,43,14,499,490,9,13
3.9041E+11,2264,1923,186,75,80,43,698,680,18,691,649,18,5,19,274,243,31,8
3.9041E+11,2325,2085,72,125,43,48,819,789,30,437,421,10,0,6,150,147,3,3
3.9041E+11,2410,2107,144,104,55,57,822,812,10,1341,1210,68,36,27,425,414,11,14
3.9041E+11,2366,2110,129,85,42,35,861,828,33,1813,1684,67,40,22,620,572,48,23
3.9041E+11,2777,2443,176,110,48,36,876,850,26,454,403,27,15,9,127,125,2,2
3.9041E+11,1465,1410,22,12,21,34,622,579,43,1401,1370,10,4,17,558,539,19,3
3.9041E+11,1904,1737,70,61,36,25,650,617,33,814,797,1,8,8,320,311,9,2
3.9041E+11,2815,2505,76,150,84,70,905,873,32,1037,986,20,17,14,359,327,32,19
3.9041E+11,1658,1578,18,9,53,36,692,648,44,1727,1698,6,2,21,666,642,24,13
3.9041E+11,2582,2511,21,14,36,28,966,927,39,2089,2033,13,7,36,744,718,26,14
3.9041E+11,2285,2015,109,105,56,45,1076,986,90,1357,1229,51,58,19,668,489,179,25
3.9041E+11,2924,2643,143,80,58,32,1122,1074,48,2035,1926,52,38,19,774,743,31,21
3.9041E+11,2145,1825,48,203,69,34,796,753,43,699,660,6,22,11,232,226,6,4
3.9041E+11,2857,2432,64,307,54,52,1078,1016,62,1037,970,25,28,14,511,445,66,7
3.9041E+11,1742,1702,5,4,31,19,675,642,33,1547,1527,10,4,6,575,552,23,5
3.9041E+11,1594,1565,16,4,9,16,609,585,24,1284,1242,19,2,21,498,465,33,7
3.9041E+11,1793,1768,3,8,14,18,706,671,35,1501,1482,2,3,14,580,552,28,6
3.9041E+11,3324,2923,39,293,69,48,1122,1053,69,918,893,0,9,16,329,317,12,9
3.9041E+11,3084,2785,125,95,79,56,1125,1049,76,1196,1166,8,1,21,469,441,28,4
3.9041E+11,2590,2406,95,56,33,45,942,900,42,1799,1722,32,22,23,797,720,77,25
3.9041E+11,1917,1714,85,24,94,89,968,917,51,1494,1416,38,8,32,858,716,142,33
3.9041E+11,1227,1188,18,5,16,9,467,438,29,1058,1040,5,0,13,407,391,16,3
3.9041E+11,2089,2038,17,8,26,14,811,776,35,1886,1858,4,7,17,677,659,18,9
3.9041E+11,1155,1098,10,12,35,21,481,456,25,966,936,8,2,20,390,376,14,13
3.9041E+11,1267,1080,65,93,29,23,612,556,56,533,485,17,24,7,190,181,9,1
3.9041E+11,1594,1132,108,277,77,71,885,848,37,823,724,37,42,20,582,480,102,16
3.9041E+11,1954,1580,113,206,55,43,906,778,128,370,335,10,14,11,163,159,4,8
3.9045E+11,1294,1252,4,0,38,14,667,512,155,1104,1076,2,1,25,521,442,79,3
3.9045E+11,1212,1175,3,6,28,7,565,536,29,1073,1053,1,7,12,498,479,19,6
3.9045E+11,1019,999,1,5,14,7,419,393,26,1005,1001,0,0,4,396,377,19,2
3.9045E+11,1916,1869,11,4,32,14,735,709,26,1666,1627,7,3,29,600,579,21,23
3.9045E+11,767,735,14,2,16,7,303,286,17,759,746,4,0,9,285,278,7,6
3.9045E+11,1878,1819,23,12,24,21,711,684,27,1659,1626,9,0,24,592,576,16,15
3.9045E+11,4736,3805,608,148,175,95,1542,1448,94,1332,1289,18,10,15,435,431,4,7
3.9045E+11,1155,1088,21,9,37,35,435,413,22,1211,1185,9,3,14,437,421,16,18
3.9045E+11,3790,3626,28,48,88,77,1385,1325,60,1953,1909,6,11,27,785,766,19,8
3.9045E+11,997,954,1,12,30,10,417,385,32,887,875,0,3,9,366,341,25,6
3.9045E+11,2159,2113,7,8,31,11,841,819,22,1934,1901,5,13,15,740,717,23,3
3.9045E+11,2336,2299,3,12,22,31,910,863,47,2040,2003,7,8,22,752,726,26,16
3.9045E+11,1938,1889,18,3,28,11,730,680,50,1689,1671,4,0,14,599,564,35,9
3.9045E+11,1202,1174,5,1,22,4,512,450,62,1151,1119,4,2,26,448,429,19,4
3.9045E+11,1319,1300,1,1,17,2,507,478,29,1103,1090,1,0,12,427,416,11,5
3.9045E+11,889,857,13,7,12,11,416,378,38,886,871,5,0,10,412,395,17,6
3.9045E+11,1376,1340,5,18,13,12,660,608,52,1015,1000,3,6,6,404,391,13,2
3.9045E+11,1008,922,14,3,69,72,499,467,32,944,895,11,7,31,494,461,33,17
3.9045E+11,898,887,2,4,5,10,390,373,17,839,821,3,7,8,386,379,7,10
3.9045E+11,1752,1655,17,15,65,64,988,923,65,1671,1623,9,15,24,961,922,39,15
3.9045E+11,1429,1380,9,7,33,30,848,708,140,1441,1409,2,8,22,819,686,133,12
3.9045E+11,1253,1227,6,11,9,9,534,506,28,1064,1043,2,15,4,417,412,5,3
3.9045E+11,1109,1069,5,4,31,14,468,445,23,1150,1128,0,16,6,459,449,10,7
3.9045E+11,2347,2262,25,8,52,18,1079,999,80,2368,2289,21,10,48,1024,988,36,12
3.9045E+11,606,565,6,7,28,24,296,264,32,616,600,7,1,8,296,279,17,6
3.9045E+11,855,827,8,2,18,14,389,361,28,827,819,3,2,3,387,367,20,2
3.9045E+11,901,844,8,3,46,32,382,340,42,838,785,1,2,50,386,339,47,17
3.9045E+11,876,850,5,5,16,9,381,358,23,903,882,2,2,17,379,354,25,6
3.9045E+11,847,804,5,0,38,27,379,336,43,844,819,5,7,13,381,352,29,20
3.9045E+11,810,780,4,1,25,17,357,313,44,766,743,1,0,22,367,326,41,20
3.9045E+11,631,612,1,5,13,4,310,266,44,679,661,4,7,7,305,276,29,8
3.9045E+11,626,593,12,4,17,12,347,291,56,740,720,6,1,13,347,308,39,4
3.9045E+11,889,859,10,2,18,7,442,415,27,945,931,0,5,9,445,423,22,2
3.9045E+11,1233,1207,4,2,20,17,515,484,31,1215,1204,3,1,7,519,495,24,6
3.9045E+11,1285,1239,9,2,35,15,572,519,53,1296,1281,1,0,14,564,526,38,20
3.9045E+11,641,607,8,1,25,11,283,249,34,701,695,2,3,1,283,262,21,0
3.9045E+11,1968,1898,19,3,48,18,858,750,108,2043,1994,12,10,27,857,782,75,20
3.9045E+11,1163,1072,31,3,57,11,475,425,50,1072,1007,35,2,28,462,409,53,4
3.9045E+11,889,874,4,3,8,8,403,379,24,800,789,2,3,6,365,350,15,1
3.9045E+11,1033,1004,14,2,13,8,418,387,31,956,941,2,1,12,407,394,13,4
3.9045E+11,1103,1074,11,2,16,7,462,430,32,957,936,1,0,20,389,375,14,7
3.9045E+11,1663,1616,28,0,19,12,631,574,57,1650,1627,5,7,11,565,527,38,5
3.9045E+11,2787,2108,627,11,41,31,498,475,23,2853,1929,889,6,29,459,438,21,33
3.9045E+11,32,32,0,0,0,0,12,11,1,26,26,0,0,0,9,9,0,0
3.9045E+11,1782,1739,8,3,32,15,653,605,48,1467,1435,10,10,12,526,492,34,2
3.9045E+11,1550,1168,280,33,69,54,582,566,16,1604,1374,144,36,50,594,592,2,33
3.9045E+11,3819,1858,1519,108,334,300,1903,1727,176,2111,1780,231,33,67,1081,1017,64,42
3.9045E+11,3521,1786,1353,135,247,190,1193,1127,66,2434,1711,569,72,82,815,783,32,45
3.9045E+11,1798,1619,109,38,32,29,578,572,6,1984,1867,55,40,22,559,555,4,25
3.9045E+11,1343,1190,88,21,44,33,517,505,12,1489,1396,44,22,27,524,519,5,16
3.9045E+11,1483,1297,102,36,48,13,464,457,7,1272,1186,46,20,20,449,400,49,12
3.9045E+11,1759,1455,222,35,47,30,585,570,15,1449,1274,113,35,27,464,453,11,9
3.9045E+11,2692,2171,303,98,120,65,881,865,16,1745,1610,112,18,5,547,537,10,27
3.9045E+11,1856,1586,168,34,68,18,649,620,29,1475,1372,68,16,19,497,481,16,11
3.9045E+11,1909,1629,177,27,76,38,843,788,55,1795,1686,51,25,33,678,665,13,39
3.9045E+11,2036,1827,139,22,48,29,704,685,19,1851,1713,64,55,19,592,588,4,14
3.9045E+11,2899,2141,476,135,147,103,1235,1079,156,1550,1413,82,19,36,597,580,17,34
3.90479E+11,1372,1315,10,0,47,43,547,516,31,1316,1286,13,1,16,499,479,20,15
3.90479E+11,1351,1309,10,6,26,16,574,525,49,1258,1203,10,2,43,505,480,25,29
3.90479E+11,1253,1141,29,0,83,67,493,434,59,1211,1140,42,1,28,453,427,26,33
3.90479E+11,1225,1191,5,12,17,7,514,463,51,1252,1231,5,4,12,482,455,27,4
3.90479E+11,1053,1014,18,3,18,2,466,425,41,1239,1216,10,1,12,468,442,26,6
3.90479E+11,1279,1183,51,2,43,23,608,532,76,1356,1226,86,0,44,616,546,70,5
3.90479E+11,803,786,6,1,10,1,352,319,33,817,793,3,4,17,371,347,24,16
3.90479E+11,1073,1016,7,23,27,17,557,509,48,991,962,3,21,5,468,449,19,8
3.90479E+11,1383,1331,23,1,28,23,634,592,42,1421,1388,12,4,17,645,611,34,22
3.90479E+11,912,864,23,0,25,20,357,295,62,951,893,23,9,26,404,367,37,8
3.90479E+11,982,890,40,7,45,25,504,434,70,1068,1032,14,2,20,483,434,49,5
3.90479E+11,2241,2058,79,18,86,40,912,832,80,1378,1285,55,4,34,573,535,38,4
3.90479E+11,674,618,12,2,42,26,297,258,39,718,679,17,3,19,309,272,37,15
3.90479E+11,875,795,52,2,26,16,328,273,55,968,902,55,1,10,334,304,30,4
3.90479E+11,1288,1209,30,3,46,43,585,546,39,1130,1064,32,3,31,473,459,14,31
3.90479E+11,749,709,20,0,20,5,355,281,74,867,789,42,0,36,362,311,51,36
3.90479E+11,814,756,32,6,20,19,374,341,33,835,751,56,2,26,379,354,25,12
3.90479E+11,1841,1720,48,35,38,13,823,791,32,1791,1693,23,42,33,812,759,53,8
3.90479E+11,733,715,5,4,9,11,361,318,43,775,755,16,0,4,349,324,25,14
3.90479E+11,809,755,22,15,17,8,375,319,56,860,803,31,6,20,394,340,54,12
3.90479E+11,1109,1068,5,13,23,6,540,491,49,1140,1112,2,17,9,492,469,23,17
3.90479E+11,887,852,20,1,14,13,377,350,27,827,803,20,1,3,383,348,35,6
3.90479E+11,1001,947,4,3,47,46,447,402,45,978,924,9,1,44,423,368,55,32
3.90479E+11,1309,1264,17,7,21,8,539,482,57,1188,1177,5,1,5,471,451,20,0
3.90479E+11,834,817,1,0,16,6,336,310,26,987,980,0,1,6,353,342,11,2
3.90479E+11,1180,1148,17,1,14,16,438,398,40,1111,1095,5,1,10,403,381,22,8
3.9049E+11,1080,1040,14,8,18,25,621,579,42,1161,1122,20,9,10,619,602,17,11
3.9049E+11,857,814,15,18,10,15,459,434,25,938,919,4,6,9,458,449,9,19
3.9049E+11,648,619,6,6,17,12,373,359,14,663,630,7,9,17,375,365,10,5
3.9049E+11,759,744,5,4,6,11,364,348,16,736,722,4,3,7,359,345,14,2
3.9049E+11,789,758,6,11,14,9,378,363,15,823,799,3,9,12,380,372,8,10
3.9049E+11,1668,1584,28,21,35,17,870,844,26,1658,1591,14,25,28,874,858,16,9
3.9049E+11,705,674,10,11,10,14,338,326,12,666,645,2,12,7,334,323,11,7
3.9049E+11,798,741,10,17,30,21,399,382,17,827,784,12,16,15,391,383,8,7
3.9049E+11,640,618,13,1,8,5,306,294,12,651,618,8,8,17,305,300,5,12
3.9049E+11,611,581,8,3,19,8,315,303,12,647,619,5,10,13,316,310,6,4
3.9049E+11,886,833,21,11,21,20,449,432,17,939,889,15,18,17,448,439,9,6
3.9049E+11,670,627,4,15,24,15,317,310,7,689,659,3,10,17,317,306,11,0
3.9049E+11,815,775,6,11,23,11,340,335,5,811,782,3,10,16,340,338,2,7
3.9049E+11,1058,1004,12,16,26,15,475,462,13,1103,1076,6,5,16,474,469,5,12
3.9049E+11,1184,1130,10,13,31,23,551,536,15,1257,1225,6,10,16,553,541,12,14
3.9049E+11,1145,774,277,26,68,46,523,479,44,1181,889,244,12,36,533,513,20,16
3.9049E+11,1419,888,377,37,117,69,739,641,98,1426,1104,233,36,53,751,612,139,34
3.9049E+11,583,473,85,9,16,15,299,265,34,718,599,86,5,28,300,289,11,15
3.9049E+11,1233,1014,149,20,50,30,573,550,23,1243,1115,56,32,40,573,554,19,23
3.9049E+11,1157,909,150,9,89,54,529,494,35,1222,1119,70,9,24,532,509,23,24
3.9049E+11,632,470,132,5,25,13,339,309,30,673,558,85,1,29,336,313,23,5
3.9049E+11,961,619,255,20,67,49,456,397,59,1056,818,176,8,54,457,429,28,32
3.9049E+11,721,534,141,2,44,26,344,311,33,734,648,56,4,26,344,332,12,7
3.9049E+11,1237,1153,37,22,25,22,630,591,39,1295,1214,18,22,41,627,604,23,34
3.9049E+11,1182,1070,25,32,55,30,673,629,44,1180,1087,28,24,41,674,638,36,35
3.9049E+11,674,630,11,10,23,22,356,327,29,682,649,9,11,13,335,330,5,18
3.9049E+11,986,936,14,10,26,24,541,515,26,1020,963,11,10,36,540,523,17,30
3.9049E+11,696,641,27,15,13,7,359,344,15,720,682,20,6,12,360,353,7,9
3.9049E+11,783,730,8,16,29,17,346,338,8,761,715,5,20,21,341,335,6,3
3.9049E+11,916,847,22,16,31,14,438,420,18,888,832,26,6,24,441,432,9,5
3.9049E+11,925,838,30,26,31,24,461,440,21,1004,935,19,16,34,524,500,24,27
3.9049E+11,1087,972,23,55,37,38,555,536,19,1090,1021,20,29,20,557,536,21,16
3.9049E+11,1129,852,34,197,46,54,747,712,35,319,263,5,37,14,213,204,9,10
3.9049E+11,624,575,16,12,21,19,293,273,20,613,571,13,13,16,291,279,12,0
3.9049E+11,1143,976,74,15,78,37,597,537,60,1177,1005,87,12,73,610,531,79,39
3.9049E+11,748,665,19,21,43,23,375,346,29,604,527,28,20,29,318,288,30,14
3.9049E+11,636,499,23,92,22,22,423,375,48,636,503,32,65,36,424,390,34,23
3.9049E+11,629,540,39,11,39,32,364,324,40,651,559,27,22,43,365,318,47,25
3.9049E+11,612,343,197,9,63,19,282,253,29,649,443,187,4,15,280,260,20,7
3.9049E+11,620,340,243,3,34,19,345,269,76,732,419,251,16,46,348,306,42,22
3.9049E+11,1129,765,281,6,77,47,513,449,64,1146,937,157,10,42,517,479,38,28
3.9049E+11,741,539,159,3,40,32,348,317,31,850,642,158,11,39,352,337,15,16
3.9049E+11,760,72,656,1,31,20,383,303,80,874,71,774,2,27,386,353,33,17
3.9049E+11,701,76,607,1,17,1,355,285,70,477,32,418,1,26,209,196,13,10
3.9049E+11,923,446,406,6,65,35,427,355,72,1400,515,810,16,59,565,531,34,48
3.9049E+11,775,35,701,8,31,20,397,298,99,978,53,874,4,47,398,361,37,16
3.9049E+11,740,46,680,1,13,10,370,314,56,770,24,725,3,18,380,343,37,6
3.9049E+11,564,39,505,0,20,16,333,224,109,825,25,777,2,21,339,286,53,22
3.9049E+11,520,34,452,0,34,23,316,192,124,697,15,643,0,39,313,237,76,1
3.9049E+11,491,25,450,1,15,10,294,192,102,639,18,609,0,12,291,246,45,3
3.9049E+11,1075,719,315,14,27,23,464,419,45,1211,877,213,81,40,489,467,22,24
3.9049E+11,619,419,170,3,27,11,317,279,38,741,487,196,29,29,319,291,28,2
3.9049E+11,846,487,290,19,50,32,363,332,31,864,605,188,25,46,354,338,16,28
3.9049E+11,1271,440,769,2,60,23,663,521,142,1365,681,586,1,97,636,535,101,23
3.9049E+11,633,240,344,7,42,18,294,237,57,679,365,288,3,23,297,263,34,2
3.9049E+11,570,387,146,13,24,18,283,271,12,644,441,188,5,10,292,279,13,7
3.9049E+11,647,429,148,18,52,22,299,281,18,784,510,225,15,34,327,315,12,11
3.9049E+11,662,163,468,1,30,21,285,239,46,722,208,481,3,30,285,261,24,14
3.9049E+11,1088,392,614,5,77,45,534,390,144,1334,634,649,5,46,534,457,77,12
3.9049E+11,849,106,691,4,48,13,400,315,85,1226,167,995,8,56,453,412,41,10
3.9049E+11,810,146,623,1,40,24,355,306,49,902,144,705,13,40,358,338,20,13
3.9049E+11,766,188,514,1,63,47,324,286,38,807,292,455,1,59,330,286,44,41
3.9049E+11,568,109,415,3,41,8,291,223,68,685,164,494,0,27,291,253,38,2
3.9049E+11,735,134,563,3,35,20,444,270,174,978,211,739,6,22,396,335,61,5
3.9049E+11,1081,966,21,58,36,35,427,422,5,972,893,28,31,20,439,427,12,13
3.9049E+11,1334,1153,75,35,71,35,696,628,68,1284,1111,101,9,63,701,635,66,32
3.9049E+11,947,858,47,15,27,29,384,349,35,844,735,49,20,40,388,367,21,24
3.9049E+11,781,703,8,43,27,26,296,293,3,683,592,15,51,25,258,252,6,16
3.9049E+11,821,761,24,14,22,22,312,300,12,681,625,13,21,22,319,304,15,17
3.9049E+11,866,783,14,38,31,25,420,388,32,890,796,26,35,33,433,390,43,13
3.9049E+11,1123,984,17,78,44,29,544,511,33,1043,834,23,162,24,558,537,21,19
3.9049E+11,1143,912,15,191,25,24,493,485,8,1103,869,20,179,35,532,520,12,13
3.9049E+11,1422,1091,68,208,55,34,418,405,13,1266,975,64,186,41,708,672,36,28
3.9049E+11,2161,1900,110,113,38,57,2,2,0,4447,3489,516,231,211,16,16,0,104
3.9049E+11,2634,2270,105,216,43,76,14,5,9,2951,2214,275,330,132,65,56,9,69
3.9049E+11,2505,2093,142,200,70,72,83,82,1,249,205,14,15,15,121,118,3,9
3.9049E+11,1488,853,149,428,58,44,825,735,90,1039,494,50,454,41,495,476,19,27
3.9049E+11,1671,1269,204,143,55,60,61,58,3,1432,1131,188,55,58,62,57,5,22
3.9049E+11,1034,906,52,44,32,32,517,484,33,999,835,66,56,42,524,478,46,27
3.9049E+11,1095,953,72,35,35,28,384,355,29,828,655,91,32,50,361,315,46,27
3.9049E+11,681,646,4,16,15,12,208,204,4,591,510,41,28,12,260,225,35,16
3.9049E+11,1324,1193,26,69,36,28,485,480,5,1295,1110,22,128,35,562,531,31,26
3.9049E+11,688,630,17,23,18,18,191,186,5,659,593,7,49,10,215,202,13,18
3.9049E+11,1310,886,271,67,86,94,667,595,72,1254,743,375,68,68,686,578,108,34
3.9049E+11,1699,1499,70,83,47,65,625,607,18,1533,1297,118,68,50,693,645,48,40
3.9049E+11,2161,1992,44,81,44,64,527,477,50,1575,1447,38,59,31,528,490,38,27
3.9049E+11,1413,1287,18,76,32,34,545,538,7,1310,1106,70,88,46,625,568,57,26
3.9049E+11,824,87,707,0,30,10,447,308,139,1086,101,932,9,44,457,369,88,2
3.9049E+11,719,130,552,5,32,21,320,244,76,711,106,568,2,35,325,275,50,3
3.9049E+11,645,24,599,1,21,10,295,254,41,689,33,641,0,15,282,261,21,22
3.9049E+11,807,32,687,65,23,3,277,256,21,850,19,785,9,37,283,259,24,20
3.9049E+11,579,43,524,2,10,8,304,223,81,684,41,611,2,30,309,252,57,11
3.9049E+11,1182,195,874,3,110,81,635,473,162,1396,158,1185,4,49,657,520,137,23
3.9049E+11,500,282,137,6,75,53,289,196,93,681,318,339,2,22,343,255,88,22
3.9049E+11,1275,954,143,82,96,100,615,569,46,1254,796,279,59,120,655,539,116,88
3.9049E+11,742,286,250,21,185,203,367,303,64,807,330,366,33,78,402,352,50,50
3.9049E+11,687,428,186,7,66,82,453,375,78,672,350,278,10,34,425,337,88,34
3.9049E+11,1076,858,41,138,39,35,463,449,14,882,724,45,82,31,382,365,17,21
3.9049E+11,934,672,69,150,43,57,457,411,46,887,693,108,40,46,485,428,57,23
3.9049E+11,599,477,21,83,18,19,335,307,28,637,493,41,73,30,320,310,10,14
3.9049E+11,677,504,43,111,19,16,347,333,14,696,490,91,62,53,401,387,14,35
3.9049E+11,1148,670,120,334,24,31,347,342,5,736,493,61,157,25,399,384,15,39
3.9049E+11,831,644,116,20,51,69,496,386,110,681,558,67,25,31,482,410,72,27
3.9049E+11,996,856,43,71,26,37,598,560,38,987,857,47,52,31,595,565,30,28
3.9049E+11,771,688,22,39,22,20,431,408,23,782,699,41,23,19,436,418,18,11
3.9049E+11,588,536,14,10,28,18,385,356,29,610,575,14,8,13,401,381,20,8
3.9049E+11,1443,1163,86,142,52,59,1060,984,76,821,721,47,19,34,577,550,27,24
3.9049E+11,718,558,38,80,42,41,579,537,42,701,576,57,35,33,550,522,28,39
3.9049E+11,1263,1185,24,23,31,22,893,825,68,1273,1190,37,18,28,872,840,32,18
3.9049E+11,740,681,22,18,19,24,566,521,45,791,727,22,22,20,569,555,14,23
3.9049E+11,689,648,9,16,16,13,528,479,49,742,696,14,9,23,502,484,18,10
3.9049E+11,956,851,49,16,40,35,555,528,27,909,779,82,21,27,538,505,33,22
3.9049E+11,911,816,31,29,35,35,564,508,56,957,876,27,20,34,596,558,38,33
3.9049E+11,1385,1170,149,24,42,28,763,723,40,1271,981,233,12,45,679,642,37,24
3.9049E+11,1808,1648,47,62,51,42,1265,1198,67,1487,1323,84,41,39,1193,1054,139,42
3.9049E+11,1851,1455,268,45,83,53,1181,1078,103,1404,949,366,21,68,1115,773,342,32
3.9049E+11,567,101,425,11,30,7,315,217,98,636,75,529,8,24,268,215,53,5
3.9049E+11,886,64,782,4,36,18,523,353,170,1170,72,1052,6,40,534,437,97,18
3.9049E+11,802,118,651,6,27,12,341,314,27,760,62,669,6,23,346,323,23,3
3.9049E+11,951,67,837,16,31,19,509,411,98,1040,46,957,5,32,524,468,56,5
3.9049E+11,1103,188,771,19,125,113,501,441,60,1178,317,813,5,43,543,491,52,23
3.9049E+11,662,46,573,0,43,14,335,292,43,683,14,632,2,35,301,285,16,6
3.9049E+11,895,130,705,6,54,15,594,462,132,1178,93,1024,5,56,617,565,52,16
3.9049E+11,1091,284,763,10,34,20,679,549,130,1236,267,932,4,33,685,626,59,14
3.9049E+11,992,209,691,4,88,26,517,410,107,1108,314,740,12,42,556,445,111,11
3.9049E+11,1021,344,641,3,33,17,573,479,94,1196,461,712,6,17,578,540,38,8
3.9049E+11,2015,405,845,20,745,821,837,726,111,1958,774,1046,15,123,954,837,117,101
3.9049E+11,1366,268,939,17,142,111,829,694,135,1661,323,1127,4,207,793,763,30,204
3.9049E+11,492,156,244,5,87,113,321,271,50,2581,854,1385,17,325,1412,1105,307,248
3.9049E+11,1224,342,780,16,86,79,633,530,103,1315,547,662,21,85,636,571,65,44
3.9049E+11,880,229,562,8,81,68,481,385,96,954,351,528,9,66,481,460,21,52
3.9049E+11,795,692,79,5,19,29,340,329,11,797,711,70,4,12,340,332,8,5
3.9049E+11,714,590,106,6,12,6,305,284,21,676,588,77,1,10,306,298,8,2
3.9049E+11,807,459,301,5,42,42,440,380,60,835,548,253,15,19,441,383,58,30
3.9049E+11,979,217,663,15,84,68,461,396,65,1296,404,751,24,117,533,491,42,165
3.9049E+11,1370,477,736,32,125,82,626,533,93,1411,749,589,19,54,636,591,45,40
3.9049E+11,829,621,162,7,39,26,427,394,33,864,714,126,3,21,430,412,18,4
3.9049E+11,1070,538,475,14,43,42,594,527,67,1154,676,413,19,46,603,559,44,9
3.9049E+11,1167,567,517,13,70,48,762,646,116,1255,777,395,16,67,757,706,51,34
3.9049E+11,596,196,354,9,37,26,295,245,50,605,297,277,10,21,290,262,28,14
3.9049E+11,1399,345,941,11,102,71,727,618,109,1466,628,744,20,74,734,684,50,32
3.9049E+11,1202,566,589,12,35,14,569,548,21,1313,686,580,13,34,569,555,14,8
3.9049E+11,1221,873,288,17,43,21,627,587,40,1126,867,223,13,23,544,523,21,5
3.9049E+11,483,38,417,1,27,0,315,206,109,688,21,639,4,24,355,267,88,2
3.9049E+11,641,28,596,0,17,5,407,269,138,877,17,820,1,39,422,345,77,10
3.9049E+11,666,17,609,5,35,10,337,290,47,863,25,753,0,85,440,381,59,1
3.9049E+11,839,194,572,7,66,19,560,408,152,922,150,713,3,56,568,456,112,14
3.9049E+11,1258,48,1094,65,51,28,742,322,420,1685,75,1469,43,98,713,658,55,19
3.9049E+11,1110,49,1005,6,50,38,684,545,139,1264,41,1176,10,37,654,540,114,8
3.9049E+11,968,700,179,37,52,31,743,665,78,712,442,236,13,21,472,439,33,17
3.9049E+11,951,770,111,46,24,22,766,667,99,508,182,312,0,14,144,143,1,10
3.9049E+11,1186,612,489,23,62,40,402,330,72,959,334,581,12,32,387,315,72,17
3.9049E+11,2147,1801,145,83,118,173,1480,1306,174,1824,1459,218,62,85,995,950,45,83
3.9049E+11,666,132,494,3,37,27,449,336,113,859,73,734,2,50,602,467,135,8
3.9049E+11,776,109,622,1,44,14,510,358,152,867,92,734,4,37,525,390,135,26
3.9049E+11,695,239,419,1,36,9,365,316,49,791,194,568,3,26,394,342,52,11
3.9049E+11,652,157,458,8,29,23,463,362,101,905,116,738,5,46,555,450,105,13
3.9049E+11,528,125,355,2,46,15,257,215,42,674,59,579,2,34,286,242,44,8
3.9049E+11,873,265,559,12,37,13,547,382,165,1044,159,827,5,53,545,411,134,13
3.9049E+11,555,187,324,1,43,12,345,286,59,737,154,545,5,33,362,313,49,7
3.9049E+11,749,485,235,3,26,16,477,383,94,756,325,386,15,30,494,416,78,15
3.9049E+11,1147,464,613,10,60,29,794,609,185,1337,367,934,5,31,819,663,156,22
3.9049E+11,1653,978,541,50,84,40,1412,1123,289,1113,754,299,17,43,975,921,54,20
3.9049E+11,1288,920,244,62,62,66,1140,1043,97,1082,776,208,47,51,920,810,110,35
3.9049E+11,1370,503,789,3,75,51,546,497,49,1432,608,724,17,83,742,561,181,23
3.9049E+11,2864,2503,70,207,84,53,1882,1780,102,1480,1331,38,90,21,1111,992,119,25
3.9049E+11,1163,958,90,29,86,85,669,578,91,990,861,58,29,42,676,428,248,21
3.9049E+11,663,508,90,6,59,37,307,214,93,784,608,84,33,59,349,287,62,29
3.9049E+11,923,585,248,21,69,38,419,328,91,1028,708,221,40,59,410,356,54,16
3.9049E+11,939,760,106,7,66,36,384,329,55,1025,893,69,16,47,385,365,20,22
3.9049E+11,872,593,200,3,76,38,284,202,82,1066,761,244,2,59,280,238,42,15
3.9049E+11,756,577,77,14,88,42,308,249,59,838,733,52,27,26,329,299,30,14
3.9049E+11,854,670,114,13,57,41,335,279,56,900,821,37,0,42,334,309,25,12
3.9049E+11,1733,1419,176,25,113,76,794,686,108,1802,1601,118,21,62,797,737,60,19
3.9049E+11,860,792,32,2,34,30,396,381,15,922,884,25,3,10,396,384,12,6
3.9049E+11,753,631,50,5,67,45,329,302,27,794,720,42,7,25,353,342,11,20
3.9049E+11,898,792,55,5,46,39,444,412,32,944,888,40,2,14,440,420,20,14
3.9049E+11,857,733,52,24,48,49,439,416,23,883,818,42,8,15,437,412,25,8
3.9049E+11,829,587,141,14,87,67,322,248,74,949,790,95,27,37,333,290,43,18
3.9049E+11,1000,732,131,20,117,108,413,320,93,1109,836,187,32,54,421,366,55,32
3.9049E+11,830,592,103,27,108,59,371,316,55,902,721,110,13,58,368,334,34,28
3.9049E+11,657,278,250,14,115,77,316,213,103,728,282,361,19,66,315,247,68,30
3.9049E+11,1233,495,565,28,145,100,617,441,176,1497,497,834,29,137,633,542,91,49
3.9049E+11,693,345,228,20,100,67,289,217,72,807,477,247,18,65,297,252,45,49
3.9049E+11,732,390,258,0,84,52,278,214,64,749,512,210,4,23,280,251,29,13
3.9049E+11,946,646,181,21,98,64,391,305,86,1024,814,147,14,49,389,345,44,9
3.9049E+11,710,543,73,1,93,50,283,225,58,707,612,62,1,32,285,257,28,3
3.9049E+11,1011,754,135,44,78,72,405,343,62,1074,865,78,83,48,405,387,18,17
3.9049E+11,668,536,80,7,45,39,313,288,25,731,662,54,1,14,314,299,15,3
3.9049E+11,1212,1051,64,20,77,42,520,472,48,1094,1036,28,7,23,516,500,16,8
3.9049E+11,1092,696,261,20,115,80,505,417,88,1226,796,329,47,54,500,447,53,24
3.9049E+11,607,461,96,10,40,44,261,229,32,600,477,105,3,15,268,248,20,8
3.9049E+11,890,661,140,32,57,38,380,321,59,969,835,86,2,46,384,354,30,8
3.9049E+11,901,764,90,2,45,58,469,356,113,988,876,68,1,43,486,422,64,34
3.9049E+11,866,661,134,25,46,43,452,372,80,944,791,105,9,39,443,409,34,16
3.9049E+11,1089,824,177,26,62,43,460,391,69,1112,908,157,11,36,463,435,28,21
3.9049E+11,874,657,110,27,80,58,362,326,36,911,702,137,49,23,361,347,14,9
3.9049E+11,1188,622,408,32,126,105,540,430,110,1309,762,425,27,95,531,473,58,41
3.9049E+11,733,354,301,1,77,64,347,254,93,786,374,327,20,65,353,301,52,31
3.9049E+11,737,568,95,10,64,19,350,237,113,985,890,41,8,46,333,296,37,16
3.9049E+11,805,623,124,2,56,24,393,269,124,1021,894,95,1,31,418,345,73,5
3.9049E+11,687,576,63,13,35,7,329,252,77,752,689,40,7,16,338,288,50,3
3.9049E+11,710,608,56,4,42,30,303,239,64,707,673,21,0,13,315,256,59,5
3.9049E+11,734,606,100,2,26,7,335,244,91,863,767,36,18,42,334,290,44,7
3.9049E+11,1188,897,205,15,71,24,536,394,142,1470,1239,174,5,52,584,465,119,5
3.9049E+11,344,182,143,0,19,4,328,215,113,777,544,207,6,20,467,421,46,42
3.9049E+11,1570,546,919,20,85,27,585,523,62,1634,707,585,4,338,658,568,90,14
3.9049E+11,358,271,77,0,10,9,219,188,31,590,507,54,5,24,339,312,27,12
3.9049E+11,931,795,89,13,34,35,572,518,54,897,761,84,11,41,576,508,68,30
3.9049E+11,1653,1520,50,45,38,29,1210,1056,154,1715,1500,158,33,24,1082,998,84,30
3.9049E+11,497,56,413,4,24,3,291,187,104,649,54,563,6,26,294,227,67,11
3.9049E+11,869,127,694,6,42,30,354,240,114,850,102,719,1,28,392,281,111,4
3.9049E+11,961,304,628,4,25,12,487,323,164,1047,204,790,8,45,543,356,187,21
3.9049E+11,727,187,516,5,19,13,426,302,124,933,110,797,6,20,430,340,90,6
3.9049E+11,1362,92,1216,2,52,19,880,565,315,1935,102,1778,5,50,925,706,219,37
3.9049E+11,722,38,657,1,26,10,396,293,103,753,35,680,3,35,388,325,63,9
3.9049E+11,633,47,545,0,41,20,358,238,120,817,27,756,0,34,367,292,75,6
3.9049E+11,796,92,660,6,38,14,394,292,102,976,37,914,0,25,408,346,62,16
3.9049E+11,632,37,571,1,23,23,373,300,73,772,34,686,34,18,375,342,33,8
3.9049E+11,782,26,724,1,31,6,443,362,81,906,29,838,1,38,442,392,50,19
3.9049E+11,648,43,562,2,41,24,364,262,102,857,51,787,1,18,363,319,44,17
3.9049E+11,440,35,372,5,28,13,247,153,94,645,35,593,1,16,256,203,53,7
3.9049E+11,692,92,548,1,51,8,318,224,94,752,102,625,7,18,313,261,52,22
3.9049E+11,419,56,306,3,54,8,281,147,134,670,59,585,1,25,294,223,71,11
3.9049E+11,615,50,522,1,42,20,298,217,81,775,69,675,2,29,303,247,56,11
3.9049E+11,880,313,515,0,52,9,486,334,152,1161,478,603,15,65,503,420,83,18
3.9049E+11,904,260,557,2,85,36,499,343,156,1214,392,776,8,38,516,414,102,10
3.9049E+11,597,332,223,1,41,27,313,226,87,733,491,217,2,23,317,277,40,14
3.9049E+11,589,323,240,7,19,9,287,214,73,710,405,263,0,42,287,269,18,24
3.9049E+11,714,463,213,2,36,23,327,276,51,839,607,196,1,35,329,301,28,7
3.9049E+11,642,462,139,4,37,10,280,226,54,688,548,109,8,23,285,250,35,17
3.9049E+11,867,720,112,8,27,20,430,392,38,758,689,42,11,16,433,406,27,11
3.9049E+11,1099,1043,22,18,16,23,738,664,74,1127,1066,39,9,13,746,689,57,17
3.9049E+11,1663,1531,53,42,37,37,1157,1058,99,1261,1188,19,23,31,829,762,67,24
3.9049E+11,730,688,20,6,16,17,468,413,55,798,741,27,7,23,477,431,46,16
3.9049E+11,564,514,32,1,17,14,310,283,27,608,553,30,9,16,324,301,23,5
3.9049E+11,1254,1128,69,18,39,24,722,660,62,1443,1269,75,20,79,739,668,71,27
3.9049E+11,939,785,74,17,63,41,525,438,87,1095,1010,47,7,31,511,446,65,24
3.9049E+11,1291,1188,55,9,39,20,665,597,68,1556,1451,58,5,42,675,623,52,26
3.9049E+11,660,102,497,8,53,17,329,237,92,874,149,660,15,50,330,301,29,20
3.9049E+11,643,245,358,10,30,17,317,274,43,775,283,453,11,28,322,301,21,18
3.9049E+11,596,151,396,8,41,7,276,221,55,649,286,344,1,18,273,245,28,6
3.9049E+11,647,100,522,4,21,8,307,217,90,862,185,653,5,19,306,269,37,15
3.9049E+11,590,232,328,0,30,25,252,203,49,661,331,274,3,53,260,235,25,12
3.9049E+11,1134,466,571,7,90,32,462,380,82,1308,535,680,6,87,472,443,29,13
3.9049E+11,621,483,100,1,37,13,307,244,63,785,661,103,4,17,309,288,21,10
3.9049E+11,505,413,63,0,29,10,273,205,68,662,580,55,5,22,272,233,39,14
3.9049E+11,695,464,200,3,28,18,388,274,114,785,555,160,1,69,379,309,70,16
3.9049E+11,759,610,87,4,58,22,418,296,122,987,884,54,5,44,430,352,78,33
3.9049E+11,439,352,64,0,23,21,244,169,75,628,537,55,5,31,279,227,52,13
3.9049E+11,1796,1545,45,139,67,70,836,795,41,1778,1612,37,81,48,794,763,31,23
3.9049E+11,627,580,9,30,8,13,226,217,9,611,562,7,35,7,181,180,1,4
3.9049E+11,1499,1211,75,166,47,36,909,860,49,899,782,15,84,18,487,424,63,24
3.9049E+11,1239,1082,21,110,26,19,578,565,13,1391,1284,12,72,23,677,648,29,15
3.9049E+11,1366,1105,37,149,75,84,812,729,83,1109,913,16,162,18,587,552,35,31
3.9049E+11,1188,539,49,554,46,29,631,565,66,840,640,25,143,32,556,442,114,14
3.9049E+11,7077,5135,202,1527,213,133,3238,2953,285,2071,1620,77,338,36,1099,911,188,29
3.9049E+11,2016,1269,53,621,73,30,872,834,38,1875,1480,36,329,30,940,809,131,29
3.9049E+11,2846,2363,125,163,195,256,1485,1344,141,687,671,1,10,5,304,281,23,32
3.9049E+11,1624,1500,14,69,41,13,641,614,27,2180,2081,34,55,10,791,759,32,26
3.9049E+11,1704,1462,27,191,24,14,523,509,14,1298,1199,11,71,17,392,380,12,7
3.9049E+11,2651,2392,29,199,31,41,847,840,7,2269,2080,47,126,16,666,650,16,18
3.9049E+11,1255,1189,2,48,16,10,455,440,15,1324,1252,3,52,17,457,448,9,10
3.9049E+11,1074,990,10,49,25,10,427,413,14,972,955,4,13,0,420,412,8,5
3.9049E+11,980,930,2,21,27,22,448,429,19,975,937,4,26,8,452,436,16,1
3.9049E+11,1130,1051,14,51,14,26,478,457,21,1072,1036,4,21,11,470,449,21,16
3.9049E+11,682,592,20,42,28,20,329,303,26,588,539,11,36,2,267,258,9,6
3.9049E+11,1365,1298,7,43,17,12,534,517,17,1362,1297,10,37,18,531,514,17,9
3.9049E+11,1023,916,3,73,31,11,445,420,25,1035,961,7,59,8,447,440,7,2
3.9049E+11,1016,906,4,83,23,21,417,402,15,1117,1048,4,54,11,415,406,9,10
3.9049E+11,1296,1140,13,108,35,22,666,606,60,1238,1168,9,50,11,661,628,33,5
3.9049E+11,1054,982,6,55,11,14,491,468,23,1086,1024,5,45,12,496,488,8,12
3.9049E+11,968,852,17,77,22,16,424,410,14,967,884,10,46,27,422,412,10,22
3.9049E+11,646,598,7,25,16,22,305,292,13,678,653,5,9,11,306,296,10,5
3.9049E+11,661,617,2,25,17,10,306,297,9,677,645,4,13,15,306,298,8,13
3.9049E+11,814,755,10,33,16,19,367,352,15,850,804,11,21,14,365,361,4,3
3.9049E+11,693,642,2,41,8,5,317,304,13,659,637,0,11,11,317,306,11,2
3.9049E+11,750,683,2,27,38,21,325,305,20,751,718,4,17,12,327,314,13,11
3.9049E+11,1152,1062,13,46,31,23,521,496,25,1168,1122,1,20,25,476,466,10,7
3.9049E+11,1793,1641,6,131,15,12,764,720,44,1872,1713,2,138,19,749,723,26,17
3.9049E+11,1312,1042,28,175,67,26,567,547,20,1259,1085,16,141,17,553,532,21,24
3.9049E+11,1480,1222,82,95,81,36,758,723,35,1612,1435,64,76,37,758,746,12,25
3.9049E+11,1162,991,70,60,41,48,628,597,31,1121,1061,24,22,14,628,618,10,13
3.9049E+11,1147,1033,36,42,36,23,547,526,21,1188,1114,19,30,25,551,542,9,16
3.9049E+11,1091,673,76,296,46,66,687,641,46,2044,1485,112,374,73,1293,1247,46,55
3.9049E+11,1059,644,77,243,95,123,580,548,32,0,0,0,0,0,0,0,0,0
3.9049E+11,835,663,68,69,35,34,580,518,62,801,634,37,87,43,564,500,64,36
3.9049E+11,1529,1286,77,90,76,46,727,692,35,1523,1413,33,50,27,730,718,12,29
3.9049E+11,1642,999,96,302,245,256,1048,959,89,1510,1176,44,246,44,1050,1005,45,35
3.9049E+11,1291,985,90,140,76,95,773,719,54,1333,1060,40,152,81,776,756,20,87
3.9049E+11,1058,831,67,70,90,115,574,515,59,1210,1088,30,56,36,676,650,26,64
3.9049E+11,1917,1615,86,153,63,54,783,748,35,2014,1740,60,156,58,768,752,16,37
3.9049E+11,1839,1337,106,180,216,279,751,716,35,1730,1423,70,168,69,762,743,19,88
3.9049E+11,1658,1069,108,378,103,92,743,706,37,1479,1263,41,131,44,666,621,45,57
3.9049E+11,1968,1316,264,169,219,208,887,809,78,1766,1334,79,278,75,890,810,80,51
3.9049E+11,2297,1743,89,320,145,181,1152,1051,101,2057,1707,36,221,93,1086,1005,81,82
3.9049E+11,1473,1037,148,167,121,158,559,539,20,1424,1170,56,150,48,560,553,7,51
3.9049E+11,2704,2160,86,395,63,34,1087,976,111,1214,1116,23,37,38,470,461,9,28
3.9049E+11,2371,1771,201,137,262,347,1044,990,54,2329,1945,104,149,131,1046,1012,34,191
3.9049E+11,1441,1205,82,39,115,91,583,564,19,1506,1336,46,68,56,583,569,14,45
3.9049E+11,809,618,58,62,71,75,431,402,29,804,652,59,51,42,431,407,24,25
3.9049E+11,1488,1218,115,94,61,67,646,611,35,1563,1356,78,68,61,655,639,16,38
3.9049E+11,684,477,47,93,67,77,388,339,49,791,601,33,109,48,442,431,11,42
3.9049E+11,1649,1362,50,192,45,29,638,617,21,1679,1354,58,234,33,602,594,8,28
3.9049E+11,1600,1408,48,70,74,65,608,591,17,1647,1483,43,83,38,583,572,11,29
3.9049E+11,674,599,9,58,8,9,224,222,2,868,804,28,33,3,252,252,0,8
3.9049E+11,1587,1184,97,200,106,85,859,779,80,1517,1306,53,103,55,784,759,25,56
3.9049E+11,1218,874,63,242,39,30,736,637,99,1186,977,22,173,14,855,721,134,11
3.9049E+11,1515,1199,104,123,89,136,617,584,33,1199,962,81,84,72,450,440,10,45
3.9049E+11,969,729,31,176,33,37,349,341,8,1031,827,14,152,38,344,342,2,2
3.9049E+11,1777,1289,196,81,211,268,732,673,59,1798,1475,118,111,94,733,712,21,79
3.9049E+11,815,743,14,29,29,17,310,307,3,853,817,7,19,10,295,293,2,5
3.9049E+11,788,714,10,53,11,9,319,305,14,864,792,4,57,11,312,305,7,9
3.9049E+11,2147,1755,55,267,70,65,1377,1272,105,1956,1614,46,240,56,1178,1078,100,50
3.9049E+11,2027,1901,42,47,37,24,757,733,24,2028,1912,36,53,27,744,728,16,30
3.9049E+11,2743,2358,77,253,55,74,1041,972,69,2075,1980,12,73,10,721,713,8,27
3.9049E+11,2072,1814,50,159,49,49,764,749,15,2213,1980,33,176,24,730,720,10,13
3.9049E+11,1750,1576,29,111,34,24,710,690,20,1837,1659,27,132,19,692,678,14,17
3.9049E+11,564,515,8,31,10,15,230,222,8,622,563,8,40,11,222,212,10,8
3.9049E+11,2610,2196,116,214,84,79,1024,987,37,2668,2338,80,158,92,923,905,18,70
3.9049E+11,1702,1380,54,229,39,36,595,583,12,1826,1558,46,195,27,548,540,8,34
3.9049E+11,927,801,39,45,42,48,390,384,6,1022,918,15,63,26,392,378,14,26
3.9049E+11,1098,955,50,51,42,37,411,400,11,1259,1111,41,91,16,434,427,7,14
3.9049E+11,1652,1417,69,81,85,81,635,620,15,1724,1571,56,56,41,636,625,11,26
3.9049E+11,2098,1654,79,270,95,43,1103,1035,68,2200,1874,68,189,69,1167,1122,45,42
3.9049E+11,1575,1096,73,294,112,88,956,871,85,1393,1002,52,313,26,901,813,88,23
3.9049E+11,1569,1294,75,121,79,85,847,791,56,1011,925,35,32,19,448,435,13,7
3.9049E+11,1028,866,28,122,12,19,575,549,26,1000,911,12,55,22,575,564,11,12
3.9049E+11,978,770,31,113,64,27,450,434,16,1325,1142,20,132,31,648,626,22,22
3.9049E+11,714,541,50,45,78,117,377,338,39,669,587,22,38,22,376,349,27,24
3.9049E+11,691,670,0,9,12,7,260,248,12,704,699,1,2,2,267,258,9,5
3.9049E+11,1009,933,8,40,28,15,532,483,49,1048,979,22,36,11,532,505,27,14
3.9049E+11,966,905,17,23,21,10,507,473,34,964,932,4,15,13,502,488,14,17
3.9049E+11,835,767,5,47,16,11,376,359,17,859,806,1,42,10,380,373,7,10
3.9049E+11,1046,980,1,46,19,18,392,382,10,1030,986,1,17,26,396,390,6,9
3.9049E+11,1026,988,5,10,23,24,358,352,6,1040,1021,4,6,9,357,355,2,14
3.9049E+11,778,637,9,102,30,24,458,369,89,786,643,22,106,15,416,396,20,19
3.9049E+11,774,590,6,149,29,20,383,358,25,772,640,22,101,9,377,357,20,16
3.9049E+11,959,928,2,13,16,15,346,340,6,950,936,0,9,5,345,339,6,8
3.9049E+11,846,816,0,12,18,16,363,344,19,883,858,1,10,14,365,359,6,13
3.9049E+11,879,870,1,6,2,13,321,298,23,866,855,0,5,6,321,315,6,6
3.9049E+11,962,919,6,30,7,10,384,360,24,793,762,4,21,6,308,303,5,6
3.9049E+11,1422,1367,9,26,20,17,594,579,15,1377,1335,6,20,16,595,582,13,4
3.9049E+11,1481,1430,14,16,21,23,615,595,20,1471,1447,9,11,4,618,606,12,10
3.9049E+11,1000,945,26,15,14,11,449,378,71,1030,998,9,17,6,482,434,48,6
3.9049E+11,1469,1300,52,51,66,33,741,706,35,1504,1371,67,35,31,729,699,30,24
3.9049E+11,1197,1132,31,5,29,26,555,522,33,1212,1166,23,10,13,548,522,26,15
3.9049E+11,566,532,10,18,6,4,284,271,13,611,571,8,25,7,285,275,10,2
3.9049E+11,963,909,25,12,17,10,409,393,16,883,841,21,10,11,273,266,7,8
3.9049E+11,985,930,3,27,25,19,355,354,1,1081,1033,3,22,23,385,382,3,12
3.9049E+11,876,848,3,11,14,13,329,323,6,969,913,1,47,8,365,358,7,8
3.9049E+11,1285,1209,34,30,12,8,525,501,24,1363,1273,33,42,15,528,521,7,10
3.9049E+11,862,681,87,32,62,40,377,349,28,854,734,48,52,20,380,364,16,4
3.9049E+11,681,637,10,11,23,10,298,280,18,693,674,4,7,8,298,291,7,3
3.9049E+11,1132,1073,15,18,26,15,515,495,20,1196,1133,10,19,34,518,511,7,18
3.9049E+11,1008,982,2,9,15,20,467,457,10,1107,1079,4,10,14,466,458,8,15
3.9049E+11,1580,789,600,53,138,76,1077,855,222,1705,1118,345,135,107,1075,994,81,53
3.9049E+11,1747,1638,52,22,35,26,1097,1011,86,1834,1745,39,23,27,1020,970,50,13
3.9049E+11,857,805,17,11,24,15,453,439,14,937,903,13,10,11,450,437,13,5
3.9049E+11,1019,950,35,12,22,18,523,498,25,1112,1049,37,11,15,521,516,5,14
3.9049E+11,858,791,7,30,30,7,355,340,15,852,803,5,32,12,360,351,9,4
3.9049E+11,672,657,2,6,7,4,296,279,17,631,606,0,10,15,297,285,12,7
3.9049E+11,738,469,165,15,89,120,474,326,148,972,697,104,47,124,500,471,29,144
3.9049E+11,754,579,100,22,53,40,398,355,43,772,674,60,21,17,383,357,26,23
3.9049E+11,962,381,320,19,242,300,542,386,156,1177,661,203,81,232,529,482,47,356
3.9049E+11,977,852,65,8,52,35,438,427,11,948,863,32,15,38,426,410,16,34
3.9049E+11,903,594,239,32,38,31,392,376,16,872,734,99,27,12,398,390,8,8
3.9049E+11,800,404,268,36,92,118,375,315,60,862,548,170,30,114,374,333,41,88
3.9049E+11,753,497,195,15,46,45,345,314,31,763,619,120,5,19,344,334,10,10
3.9049E+11,825,572,201,25,27,36,356,338,18,743,650,63,10,20,312,306,6,10
3.9049E+11,1891,1222,535,38,96,74,755,731,24,1965,1667,233,12,53,822,796,26,44
3.9049E+11,1786,753,862,36,135,90,1114,934,180,1959,1177,506,166,110,1122,1070,52,55
3.9049E+11,1164,295,727,36,106,162,494,460,34,1021,414,498,27,82,509,468,41,54
3.9049E+11,644,263,305,16,60,69,302,284,18,682,467,117,30,68,331,310,21,31
3.9049E+11,1379,783,482,69,45,72,566,526,40,1394,1050,259,36,49,567,541,26,26
3.9049E+11,1063,463,465,15,120,170,420,381,39,1052,684,243,29,96,419,408,11,42
3.9049E+11,1137,389,508,39,201,260,441,400,41,911,609,224,23,55,413,400,13,37
3.9049E+11,862,456,331,17,58,71,406,397,9,820,601,151,42,26,408,392,16,27
3.9049E+11,1215,411,651,44,109,89,509,481,28,1177,566,502,55,54,469,448,21,24
3.9049E+11,645,256,296,26,67,71,292,281,11,589,390,141,27,31,292,280,12,20
3.9049E+11,1081,548,445,37,51,31,440,420,20,1139,865,192,43,39,441,436,5,25
3.9049E+11,1310,509,642,55,104,69,452,422,30,1214,727,393,34,60,428,413,15,43
3.9049E+11,859,355,430,28,46,45,329,318,11,903,510,317,47,29,329,323,6,20
3.9049E+11,886,448,371,26,41,70,357,344,13,821,544,213,25,39,355,342,13,28
3.9049E+11,2014,608,1250,20,136,286,804,707,97,1632,685,766,16,165,686,639,47,161
3.9049E+11,903,219,602,4,78,71,442,397,45,919,433,426,14,46,440,422,18,14
3.9049E+11,1054,279,671,6,98,88,594,520,74,1133,404,595,15,119,628,560,68,90
3.9049E+11,1286,338,803,11,134,150,738,601,137,1364,348,833,42,141,732,678,54,75
3.9049E+11,1167,640,445,22,60,69,562,537,25,1150,820,197,27,106,520,491,29,51
3.9049E+11,972,687,202,16,67,55,425,402,23,1030,901,78,23,28,426,419,7,26
3.9049E+11,1336,682,527,19,108,102,522,479,43,1206,866,282,17,41,494,467,27,17
3.9049E+11,1027,781,176,31,39,44,434,417,17,1154,982,108,44,20,498,484,14,17
3.9049E+11,1154,557,534,13,50,39,463,442,21,1130,806,219,25,80,479,463,16,32
3.9049E+11,798,583,177,9,29,21,352,337,15,797,651,110,14,22,333,328,5,25
3.9049E+11,1370,1013,288,18,51,39,645,619,26,1367,1164,145,21,37,614,597,17,16
3.9049E+11,680,518,103,6,53,43,289,279,10,678,585,64,7,22,268,264,4,11
3.9049E+11,1264,804,370,27,63,47,581,555,26,1308,1116,142,17,33,612,593,19,18
3.9049E+11,1382,436,673,31,242,252,579,525,54,1369,733,553,9,74,581,553,28,87
3.9049E+11,1858,772,914,32,140,188,1079,909,170,1792,1303,364,37,88,1061,986,75,55
3.9049E+11,2113,818,1006,49,240,303,1100,1015,85,1945,1202,573,56,114,1051,943,108,98
3.9049E+11,1942,1845,14,58,25,16,872,828,44,1884,1806,9,53,16,821,804,17,9
3.9049E+11,802,767,10,12,13,12,466,431,35,802,770,11,15,6,450,433,17,4
3.9049E+11,1271,1120,92,15,44,32,575,550,25,1379,1302,33,23,21,594,581,13,13
3.9049E+11,1212,1094,57,39,22,6,437,428,9,1303,1247,17,25,14,428,423,5,14
3.9049E+11,1592,1519,28,19,26,19,584,566,18,1777,1701,24,37,15,583,578,5,9
3.9049E+11,859,442,305,12,100,96,594,543,51,830,612,140,39,39,610,568,42,23
3.9049E+11,1442,474,646,18,304,381,674,557,117,1463,875,450,54,84,716,669,47,70
3.9049E+11,876,537,296,11,32,21,375,362,13,862,705,98,5,54,377,366,11,18
3.9049E+11,806,548,229,6,23,16,324,316,8,736,636,68,8,24,313,306,7,19
3.9049E+11,2120,1929,104,23,64,44,415,389,26,2145,2004,80,24,37,458,443,15,27
3.9049E+11,1862,1708,61,34,59,57,701,686,15,2021,1907,52,31,31,693,688,5,36
3.9049E+11,1587,1477,49,16,45,23,743,704,39,1705,1659,11,2,33,744,726,18,31
3.9049E+11,1427,1293,64,19,51,24,553,537,16,1458,1379,35,15,29,549,546,3,6
3.9049E+11,1496,1406,44,11,35,32,671,626,45,1581,1501,31,19,30,672,653,19,26
3.9049E+11,2062,1794,59,165,44,68,1006,923,83,2107,1830,64,156,57,957,885,72,38
3.9049E+11,2711,1979,319,144,269,351,1371,1267,104,2257,1874,163,97,123,1116,1058,58,67
3.9049E+11,1336,1124,77,113,22,45,690,665,25,940,853,17,54,16,370,352,18,12
3.9049E+11,1704,1141,217,293,53,71,827,762,65,1576,1316,99,104,57,829,753,76,46
3.9049E+11,1345,1021,135,136,53,37,824,716,108,1305,1056,112,105,32,773,683,90,37
3.9049E+11,2565,1882,163,435,85,79,1033,1004,29,2210,1867,109,176,58,761,738,23,56
3.9049E+11,1336,1091,103,105,37,36,488,478,10,1386,1135,97,112,42,478,471,7,33
3.9049E+11,2391,1757,294,131,209,273,1184,1105,79,2063,1775,154,66,68,1179,1086,93,47
3.9049E+11,2863,2266,282,178,137,130,1267,1211,56,2841,2394,220,135,92,1246,1210,36,54
3.9049E+11,2809,2087,257,344,121,167,1168,1126,42,2369,1984,187,144,54,1038,1003,35,50
3.9049E+11,2267,876,1147,96,148,165,756,727,29,1500,869,498,52,81,571,542,29,34
3.9049E+11,1607,1271,254,23,59,47,697,664,33,1551,1432,70,7,42,721,650,71,12
3.9049E+11,1557,716,646,96,99,182,649,585,64,956,621,233,78,24,327,318,9,19
3.9049E+11,999,594,283,26,96,65,330,316,14,1012,764,192,25,31,325,318,7,20
3.9049E+11,1207,629,442,44,92,90,466,456,10,772,611,94,31,36,394,371,23,4
3.9049E+11,2712,1549,944,92,127,140,1077,1025,52,2561,1789,584,95,93,1070,1016,54,36
3.9049E+11,942,751,137,18,36,26,464,444,20,717,610,63,16,28,349,332,17,20
3.9049E+11,1181,801,281,25,74,69,530,496,34,1187,1027,109,6,45,530,512,18,31
3.9049E+11,2700,1580,890,75,155,143,1415,1264,151,2070,1529,398,66,77,1041,966,75,34
3.9049E+11,972,575,321,17,59,63,613,536,77,1024,854,121,19,30,677,566,111,30
3.9049E+11,1175,350,679,15,131,140,525,483,42,914,565,235,33,81,483,418,65,45
3.9049E+11,1079,474,415,29,161,138,425,401,24,1043,736,225,24,58,464,423,41,36
3.9049E+11,762,463,227,8,64,46,298,285,13,802,639,141,8,14,300,294,6,11
3.9049E+11,1392,565,647,28,152,115,731,661,70,1202,827,290,14,71,736,680,56,38
3.9049E+11,1938,1689,145,30,74,61,727,686,41,2220,2106,60,27,27,786,770,16,14
3.9049E+11,1632,1189,313,20,110,79,657,586,71,1760,1488,192,16,64,660,627,33,31
3.9049E+11,1547,1240,186,25,96,49,556,529,27,949,896,21,5,27,360,357,3,17
3.9049E+11,1287,1023,147,39,78,49,503,479,24,1397,1197,119,30,51,507,501,6,31
3.9049E+11,2346,1758,298,198,92,105,1266,1140,126,1625,1427,104,59,35,943,811,132,28
3.9049E+11,1742,1307,256,112,67,51,932,863,69,1320,1064,152,55,49,717,606,111,37
3.9049E+11,2047,1508,305,113,121,72,951,903,48,1940,1703,159,31,47,949,901,48,26
3.9049E+11,840,782,27,9,22,25,426,415,11,881,841,21,9,10,429,409,20,10
3.9049E+11,1362,1262,49,18,33,13,527,511,16,1496,1424,39,18,15,505,497,8,9
3.9049E+11,772,668,59,21,24,14,269,264,5,800,754,19,17,10,249,245,4,8
3.9049E+11,1653,1516,61,19,57,28,602,589,13,1535,1487,17,15,16,498,490,8,5
3.9049E+11,744,681,25,16,22,16,291,285,6,803,776,7,7,13,291,284,7,13
3.9049E+11,945,877,28,21,19,10,385,377,8,904,887,8,7,2,342,335,7,9
3.9049E+11,1781,1628,87,33,33,30,685,673,12,1981,1834,87,34,26,715,699,16,18
3.9049E+11,1248,1142,55,18,33,16,545,529,16,1299,1245,24,23,7,547,534,13,4
3.9049E+11,1489,1342,85,26,36,18,618,592,26,1457,1337,68,21,31,535,517,18,10
3.9049E+11,1899,1577,215,28,79,35,816,766,50,1962,1809,89,31,33,831,800,31,11
3.9049E+11,2812,2281,317,76,138,127,1205,1142,63,2728,2468,158,56,46,1092,1074,18,30
3.9049E+11,1256,878,240,30,108,52,637,606,31,1242,1059,123,31,29,617,607,10,20
3.9049E+11,2274,1540,463,136,135,95,1040,982,58,2451,1939,327,102,83,1079,1029,50,54
3.9049E+11,1741,1182,454,36,69,63,694,659,35,1802,1463,249,37,53,693,682,11,22
3.9049E+11,186,172,4,6,4,2,73,68,5,224,213,4,7,0,76,73,3,4
3.9049E+11,427,405,3,9,10,1,173,168,5,459,434,5,12,8,169,167,2,2
3.9049E+11,957,570,329,25,33,20,478,446,32,909,622,228,18,41,460,424,36,3
3.9049E+11,1958,1129,639,49,141,117,1049,878,171,2083,1394,522,55,112,1011,951,60,52
3.9049E+11,2610,2187,103,254,66,31,939,828,111,744,718,13,9,4,335,273,62,1
3.9049E+11,623,586,7,11,19,5,236,220,16,648,641,1,3,3,273,236,37,0
3.9049E+11,1416,1236,84,48,48,40,850,750,100,58,58,0,0,0,18,18,0,0
3.9049E+11,767,661,46,36,24,15,547,448,99,170,162,2,3,3,105,78,27,2
3.9049E+11,1527,1300,150,36,41,41,955,854,101,57,54,0,3,0,22,20,2,0
3.9049E+11,988,856,96,13,23,15,497,465,32,219,205,5,4,5,88,83,5,3
3.9049E+11,1604,1279,172,86,67,41,895,814,81,503,433,46,21,3,173,167,6,1
3.9049E+11,1581,1346,133,54,48,48,836,773,63,445,403,24,9,9,194,186,8,2
3.9049E+11,2630,2119,299,144,68,54,1679,1452,227,612,525,47,33,7,373,313,60,6
3.9049E+11,3076,2275,175,558,68,66,1099,1048,51,180,169,3,6,2,86,66,20,3
3.9049E+11,947,840,27,49,31,23,378,343,35,624,589,15,13,7,234,218,16,2
3.9049E+11,3298,2830,130,254,84,74,1313,1238,75,1953,1759,44,107,43,819,741,78,20
3.9049E+11,2611,2364,75,119,53,73,806,756,50,1557,1471,22,40,24,494,472,22,17
3.9049E+11,1344,1204,47,67,26,15,511,461,50,930,866,25,29,10,295,274,21,8
3.9049E+11,2256,1879,240,87,50,46,775,754,21,1264,1097,98,50,19,445,435,10,20
3.9049E+11,2306,2037,159,80,30,42,866,849,17,2618,2303,158,121,36,877,869,8,18
3.9049E+11,1853,1454,238,80,81,68,1154,1069,85,464,414,26,21,3,288,271,17,0
3.9049E+11,2327,2050,120,102,55,27,835,822,13,2472,2250,92,103,27,816,806,10,20
3.9049E+11,762,677,43,21,21,12,271,266,5,559,518,18,12,11,195,188,7,5
3.9049E+11,738,663,35,34,6,10,296,278,18,526,510,11,3,2,226,222,4,3
3.9049E+11,1306,1169,63,49,25,11,477,448,29,934,866,31,22,15,328,316,12,6
3.9049E+11,1681,939,546,77,119,74,873,817,56,541,447,66,11,17,357,333,24,13
3.9049E+11,4112,3084,750,92,186,151,1964,1824,140,1266,1097,120,15,34,572,506,66,14
3.9049E+11,960,362,508,28,62,13,383,339,44,450,179,246,0,25,170,154,16,14
3.9049E+11,2376,1570,633,77,96,78,855,800,55,501,431,51,5,14,186,176,10,16
3.9049E+11,1426,983,374,17,52,40,856,772,84,1416,1035,332,11,38,752,696,56,33
3.9049E+11,726,322,316,17,71,98,385,354,31,934,637,234,13,50,528,447,81,8
3.9049E+11,74,60,9,0,5,2,33,28,5,111,101,0,0,10,40,36,4,8
3.9049E+11,8339,5535,2320,169,315,264,3194,3006,188,1017,912,59,25,21,409,363,46,11
3.9049E+11,1426,1175,159,64,28,26,565,530,35,803,671,70,50,12,300,285,15,9
3.9049E+11,874,468,256,96,54,57,380,337,43,365,330,29,0,6,153,137,16,2
3.9049E+11,1099,808,163,21,107,77,429,405,24,882,736,82,14,50,343,327,16,30
3.9049E+11,1021,923,51,15,32,39,419,403,16,1005,934,32,23,16,418,408,10,4
3.9049E+11,936,813,75,4,44,23,372,356,16,1150,1050,62,17,21,465,436,29,9
3.9049E+11,830,697,59,37,37,23,310,298,12,879,806,37,20,16,311,304,7,15
3.9049E+11,710,472,207,3,28,8,405,378,27,789,627,111,21,30,416,390,26,18
3.9049E+11,788,717,33,20,18,8,307,302,5,897,802,51,36,8,307,303,4,7
3.9049E+11,1064,857,123,17,67,39,477,451,26,1067,921,97,12,37,458,425,33,14
3.9049E+11,1015,830,136,4,45,56,377,361,16,968,867,71,5,25,376,369,7,21
3.9049E+11,1838,1632,100,27,79,38,865,817,48,1920,1800,51,26,43,863,840,23,20
3.9049E+11,985,893,54,14,24,15,445,419,26,1041,984,41,6,10,441,427,14,2
3.9049E+11,1698,1226,353,49,70,69,741,687,54,1765,1440,208,60,57,731,677,54,65
3.9049E+11,2821,2252,387,98,84,51,981,957,24,2856,2292,365,126,73,921,905,16,36
3.9049E+11,1511,1186,212,40,73,36,607,588,19,1637,1329,194,78,36,608,596,12,21
3.9049E+11,2350,1939,220,91,100,45,863,844,19,2414,2062,239,74,39,808,796,12,21
3.9049E+11,1416,1154,147,88,27,31,535,521,14,797,664,71,47,15,246,245,1,4
3.9049E+11,1972,1488,297,111,76,54,983,938,45,2887,2434,249,142,62,1336,1248,88,41
3.9049E+11,2355,1759,450,52,94,50,901,866,35,2363,1897,361,41,64,886,867,19,18
3.9049E+11,1986,1622,249,68,47,35,676,665,11,2168,1829,224,60,55,676,670,6,35
3.9049E+11,1118,132,916,8,62,16,476,421,55,888,267,581,1,39,415,354,61,14
3.9049E+11,733,30,671,0,32,7,296,265,31,770,29,717,1,23,310,276,34,18
3.9049E+11,948,67,842,1,38,22,403,371,32,1021,87,903,2,29,394,379,15,9
3.9049E+11,1863,210,1570,5,78,39,789,742,47,1345,70,1227,10,38,485,473,12,12
3.9049E+11,1242,76,1088,5,73,26,559,490,69,1435,101,1322,1,11,568,531,37,7
3.9049E+11,1685,424,1143,1,117,54,640,552,88,1851,618,1115,10,108,670,615,55,16
3.9049E+11,658,123,520,5,10,7,265,220,45,707,130,542,0,35,258,236,22,3
3.9049E+11,978,219,716,0,43,10,385,342,43,781,236,516,2,27,304,280,24,11
3.9049E+11,1412,656,546,26,184,239,692,572,120,1448,803,500,19,126,682,649,33,77
3.9049E+11,1084,207,700,28,149,142,498,406,92,1100,289,623,19,169,517,475,42,56
3.9049E+11,2080,255,1568,17,240,195,945,788,157,2255,576,1466,39,174,954,901,53,155
3.9049E+11,667,161,438,0,68,105,308,283,25,736,195,495,2,44,326,305,21,10
3.9049E+11,902,93,739,16,54,30,424,365,59,1121,302,758,14,47,518,433,85,20
3.9049E+11,2192,598,1443,41,110,95,857,783,74,2316,785,858,87,586,936,812,124,38
3.9049E+11,1479,63,1365,2,49,33,520,500,20,1297,54,1177,3,63,472,458,14,14
3.9049E+11,1595,134,1397,1,63,41,678,652,26,1527,167,1288,2,70,612,591,21,22
3.9049E+11,1276,732,461,16,67,35,339,313,26,566,359,158,27,22,71,66,5,22
3.9049E+11,6412,1020,4737,279,376,278,2894,2681,213,1839,86,1623,20,110,806,683,123,12
3.9049E+11,1726,70,1593,8,55,11,641,618,23,1533,32,1390,0,111,612,538,74,13
3.9049E+11,1135,326,707,14,88,41,578,506,72,955,399,480,15,61,478,439,39,30
3.9049E+11,1156,496,583,21,56,65,473,442,31,1145,678,387,38,42,454,438,16,37
3.9049E+11,1054,745,240,3,66,36,465,435,30,1143,941,152,20,30,470,459,11,12
3.9049E+11,891,585,225,13,68,66,416,375,41,1001,762,151,22,66,433,403,30,38
3.9049E+11,915,519,285,8,103,85,428,380,48,787,605,159,7,16,373,359,14,7
3.9049E+11,1018,275,630,3,110,104,450,361,89,1233,353,673,9,198,473,438,35,34
3.9049E+11,1094,387,502,2,203,175,694,492,202,1603,670,773,36,124,781,721,60,73
3.9049E+11,992,435,394,17,146,204,518,405,113,1106,538,448,26,94,497,468,29,102
3.9049E+11,1136,170,510,210,246,254,607,455,152,1278,273,747,52,206,614,562,52,155
3.9049E+11,769,497,176,46,50,60,330,314,16,882,688,128,27,39,359,346,13,23
3.9049E+11,1233,808,294,32,99,98,720,567,153,1311,1008,228,25,50,719,644,75,50
3.9049E+11,1208,700,365,50,93,96,693,534,159,1250,940,228,52,30,707,609,98,11
3.9049E+11,1656,947,573,52,84,62,724,692,32,1576,1194,229,101,52,725,710,15,17
3.9049E+11,1269,807,284,34,144,176,600,550,50,1267,942,229,58,38,599,583,16,40
3.9049E+11,1653,1359,207,29,58,56,945,856,89,1675,1588,56,14,17,937,894,43,11
3.9049E+11,584,557,11,7,9,2,302,295,7,649,620,13,10,6,314,309,5,5
3.9049E+11,869,790,13,39,27,18,494,468,26,907,816,22,39,30,496,476,20,14
3.9049E+11,1301,1197,26,38,40,31,608,592,16,1303,1238,19,32,14,614,603,11,14
3.9049E+11,707,544,52,86,25,26,446,398,48,664,523,42,75,24,447,414,33,12
3.9049E+11,912,759,56,37,60,34,518,455,63,1090,943,13,122,12,494,468,26,23
3.9049E+11,809,735,40,13,21,16,371,334,37,860,800,29,23,8,344,336,8,4
3.9049E+11,1612,1423,87,59,43,37,918,835,83,1664,1441,58,117,48,842,799,43,19
3.9049E+11,761,700,15,23,23,9,336,320,16,730,715,9,6,0,337,330,7,4
3.9049E+11,712,363,52,262,35,33,372,362,10,853,308,58,405,82,380,376,4,35
3.9049E+11,1403,789,183,332,99,87,767,697,70,2031,1065,182,623,161,1205,1112,93,78
3.9049E+11,961,464,64,362,71,56,546,520,26,945,423,95,355,72,545,533,12,31
3.9049E+11,1019,549,64,382,24,12,527,522,5,1039,501,71,439,28,525,522,3,38
3.9049E+11,547,488,12,22,25,7,266,252,14,555,523,19,2,11,267,259,8,1
3.9049E+11,829,559,36,193,41,37,570,554,16,920,665,32,171,52,598,574,24,39
3.9049E+11,1343,1105,62,123,53,59,1053,961,92,1174,1026,24,81,43,938,901,37,28
3.9049E+11,1349,1286,14,18,31,14,556,523,33,1486,1440,10,9,27,582,557,25,19
3.9049E+11,3346,2810,83,362,91,45,1109,1069,40,608,570,10,7,21,210,201,9,16
3.9049E+11,3024,2500,270,152,102,77,1049,1003,46,2737,2517,78,72,70,906,886,20,72
3.9049E+11,1501,1392,11,69,29,12,484,475,9,1696,1595,15,63,23,477,471,6,18
3.9049E+11,2600,2317,80,107,96,111,1168,1082,86,2629,2402,31,94,102,1056,1031,25,85
3.9049E+11,2195,1968,42,59,126,94,804,778,26,2231,2119,30,49,33,816,792,24,38
3.9049E+11,1980,1767,78,53,82,60,831,796,35,1925,1804,25,41,55,826,751,75,55
3.9049E+11,1044,1014,14,5,11,24,425,410,15,1091,1061,8,8,14,427,423,4,13
3.9049E+11,2566,2252,77,123,114,105,977,953,24,2226,2094,31,76,25,840,827,13,35
3.9049E+11,1421,1221,69,65,66,39,517,502,15,2342,2102,75,92,73,878,854,24,45
3.9049E+11,2595,2321,75,120,79,81,955,935,20,1895,1738,42,76,39,640,635,5,24
3.9049E+11,2588,2152,123,206,107,90,1263,1177,86,2604,2375,69,99,61,1189,1085,104,57
3.9049E+11,3480,2886,181,237,176,123,1768,1647,121,2131,1940,72,68,51,766,732,34,34
3.9049E+11,2224,2018,53,106,47,48,828,813,15,2483,2331,33,97,22,844,837,7,24
3.9049E+11,1853,1729,16,84,24,27,640,632,8,2038,1910,17,87,24,639,634,5,10
3.9049E+11,829,798,5,11,15,5,363,329,34,822,785,19,8,10,352,333,19,2
3.9049E+11,1054,1014,3,10,27,12,432,425,7,1190,1159,1,23,7,459,452,7,12
3.9049E+11,1066,1002,4,50,10,18,410,400,10,1016,931,6,63,16,362,354,8,8
3.9049E+11,2168,2004,36,60,68,71,1182,1110,72,2364,2164,30,124,46,1139,1073,66,48
3.9049E+11,1694,1549,38,46,61,36,805,765,40,1376,1295,15,30,36,651,638,13,13
3.9049E+11,1446,1288,13,112,33,20,559,545,14,1585,1436,7,122,20,555,542,13,10
3.9049E+11,883,746,44,72,21,20,271,267,4,849,744,53,45,7,249,243,6,1
3.9049E+11,1189,1019,55,45,70,73,627,588,39,1171,1085,42,29,15,619,537,82,18
3.9049E+11,2763,2162,341,142,118,105,1022,992,30,1880,1624,127,67,62,705,683,22,61
3.9049E+11,577,528,10,9,30,23,227,215,12,563,554,0,2,7,218,217,1,14
3.9049E+11,1157,966,68,79,44,32,633,600,33,1280,1158,48,26,48,687,634,53,37
3.9049E+11,2427,1878,169,232,148,127,1054,1000,54,1407,1274,58,49,26,705,663,42,17
3.9049E+11,1747,1270,261,132,84,84,643,603,40,1542,1322,81,70,69,643,596,47,19
3.9049E+11,2628,1601,451,100,476,555,1232,1057,175,2295,1716,224,157,198,1181,1043,138,170
3.9049E+11,857,714,57,50,36,39,410,378,32,798,756,30,5,7,381,361,20,5
3.9049E+11,3389,3139,86,62,102,86,1104,1081,23,2689,2529,41,21,98,897,871,26,36
3.9049E+11,1092,1033,15,18,26,24,403,396,7,1060,1022,11,12,15,396,386,10,15
3.9049E+11,929,905,0,12,12,13,309,301,8,743,732,0,6,5,234,230,4,10
3.9049E+11,1300,1103,67,19,111,101,573,541,32,1420,1322,30,7,61,578,553,25,130
3.9049E+11,568,419,72,9,68,79,365,283,82,730,554,61,8,107,371,354,17,107
3.9049E+11,751,686,30,3,32,28,321,307,14,723,706,8,2,7,320,314,6,2
3.9049E+11,831,630,135,12,54,22,425,391,34,869,773,72,1,23,427,414,13,14
3.9049E+11,523,432,50,0,41,41,356,264,92,756,580,73,11,92,364,337,27,107
3.9049E+11,1278,876,79,8,315,319,597,503,94,1436,1277,68,17,74,640,598,42,69
3.9049E+11,1404,1138,72,26,168,178,566,526,40,1151,1101,19,6,25,457,433,24,21
3.9049E+11,1107,937,39,1,130,126,460,437,23,1173,1130,17,1,25,480,471,9,7
3.9049E+11,1506,967,304,49,186,177,526,496,30,1520,1277,153,20,70,529,511,18,50
3.9049E+11,2205,1645,187,25,348,330,1031,923,108,2048,1847,116,10,75,997,929,68,56
3.9049E+11,1291,1126,95,25,45,47,471,452,19,1325,1158,112,12,43,467,448,19,23
3.9049E+11,1617,1031,217,24,345,421,751,632,119,1677,1489,115,37,36,730,693,37,50
3.9049E+11,3841,3224,241,165,211,207,1430,1358,72,1823,1662,56,77,28,614,598,16,21
3.9049E+11,2415,1994,195,61,165,172,966,924,42,1468,1232,88,64,84,1101,654,447,50
3.9049E+11,1319,1242,28,4,45,64,572,527,45,1255,1228,7,3,17,571,551,20,17
3.9049E+11,3372,2312,335,147,578,672,1735,1579,156,667,598,43,18,8,268,264,4,7
3.9049E+11,1215,978,86,73,78,75,439,424,15,874,736,51,44,43,344,307,37,35
3.9049E+11,2219,1788,145,135,151,132,1057,1004,53,2287,1955,114,89,129,1060,1013,47,100
3.9049E+11,3381,2478,472,58,373,337,1309,1234,75,2932,2546,222,54,110,1179,1114,65,55
3.9049E+11,570,547,1,3,19,14,216,204,12,469,457,6,0,6,187,182,5,1
3.9049E+11,3215,2473,393,62,287,275,1492,1372,120,1727,1543,114,34,36,1017,816,201,36
3.9049E+11,1334,1231,33,10,60,56,486,466,20,1481,1394,41,7,39,499,483,16,26
3.9049E+11,2626,2177,178,111,160,160,1043,979,64,1638,1565,35,11,27,606,580,26,20
3.9049E+11,1406,693,153,18,542,669,667,577,90,1298,1021,98,10,169,669,626,43,293
3.9049E+11,1117,962,55,30,70,44,398,385,13,1194,1087,65,13,29,406,401,5,12
3.9049E+11,2642,2201,184,45,212,244,1092,1016,76,2285,2061,115,33,76,933,886,47,65
3.9049E+11,1733,1004,220,88,421,433,778,723,55,1609,1276,161,20,152,779,723,56,170
3.9049E+11,1785,1039,215,23,508,518,791,748,43,1345,1221,71,4,49,665,639,26,42
3.9049E+11,1851,1094,357,26,374,370,706,568,138,2148,1656,322,24,146,795,749,46,142
3.9049E+11,2157,1636,196,54,271,286,969,869,100,2350,2102,139,30,79,975,942,33,74
3.9049E+11,900,757,48,15,80,79,400,363,37,860,768,49,29,14,402,380,22,10
3.9049E+11,1310,866,166,56,222,293,680,594,86,1335,964,226,43,102,685,657,28,88
3.9049E+11,511,264,117,1,129,129,510,208,302,2062,1197,346,30,489,900,713,187,939
3.9049E+11,1234,476,380,2,376,409,580,342,238,2231,1260,409,19,543,869,721,148,888
3.9049E+11,1815,1179,331,17,288,330,845,806,39,1516,1228,171,31,86,754,719,35,40
3.9049E+11,957,768,42,11,136,201,382,358,24,815,791,5,13,6,401,375,26,0
3.9049E+11,1555,1037,157,127,234,210,619,589,30,1557,1147,162,156,92,614,585,29,115
3.9049E+11,1898,1684,69,112,33,30,819,802,17,2070,1830,55,140,45,815,810,5,32
3.9049E+11,1972,1392,211,161,208,224,925,839,86,1360,1004,85,163,108,726,652,74,109
3.9049E+11,1000,828,52,24,96,104,432,399,33,1025,944,39,17,25,438,417,21,14
3.9049E+11,1797,902,761,25,109,86,820,747,73,1227,1009,157,16,45,622,566,56,16
3.9049E+11,1636,1350,91,30,165,177,691,646,45,1593,1502,42,30,19,686,666,20,8
3.9049E+11,1424,705,279,23,417,433,554,518,36,1243,979,163,26,75,558,538,20,74
3.9049E+11,1061,460,418,45,138,85,520,432,88,838,571,190,29,48,483,423,60,15
3.9049E+11,924,274,445,55,150,173,335,275,60,743,499,126,7,111,335,281,54,81
3.9049E+11,1021,838,55,49,79,70,397,377,20,1086,992,26,47,21,415,409,6,16
3.9049E+11,869,731,69,18,51,57,447,385,62,783,695,40,9,39,411,355,56,35
3.9049E+11,930,662,82,53,133,188,329,305,24,885,780,23,66,16,330,319,11,7
3.9049E+11,785,609,81,42,53,41,375,350,25,811,732,33,19,27,372,363,9,5
3.9049E+11,849,718,63,32,36,35,372,345,27,827,775,21,13,18,372,363,9,9
3.9049E+11,665,513,89,25,38,47,321,281,40,638,573,33,13,19,298,281,17,5
3.9049E+11,834,633,118,9,74,54,393,318,75,927,676,170,47,34,393,374,19,12
3.9049E+11,1538,1336,114,12,76,47,912,838,74,1534,1414,67,8,45,916,855,61,15
3.9049E+11,1208,978,105,61,64,56,513,482,31,1113,992,68,34,19,510,486,24,10
3.9049E+11,956,811,90,0,55,52,399,354,45,982,849,58,8,67,397,370,27,34
3.9049E+11,1167,1094,43,10,20,18,522,470,52,1210,1146,21,7,36,538,504,34,15
3.9049E+11,577,521,40,2,14,7,264,239,25,678,622,25,6,25,290,269,21,7
3.9049E+11,1362,1058,210,31,63,61,577,534,43,1381,1181,129,43,28,539,508,31,13
3.9049E+11,2599,1957,366,85,191,136,956,884,72,2105,1743,244,49,69,781,730,51,25
3.9049E+11,2027,1519,391,63,54,67,647,579,68,2053,1461,474,73,45,647,632,15,8
3.9049E+11,2537,1639,504,54,340,320,1162,1075,87,2356,1958,283,19,96,1090,1044,46,43
3.9049E+11,2440,738,1432,38,232,262,808,746,62,1521,783,606,6,126,691,489,202,81
3.9049E+11,1707,1061,445,40,161,192,747,706,41,1588,1239,252,60,37,751,666,85,28
3.9049E+11,2206,1688,287,108,123,113,787,748,39,1923,1669,133,84,37,679,662,17,18
3.9049E+11,2725,2294,213,46,172,124,978,922,56,2575,2362,121,17,75,920,870,50,23
3.9049E+11,1435,1197,153,21,64,61,418,393,25,1420,1300,90,3,27,413,403,10,15
3.9049E+11,2338,2192,52,29,65,54,975,922,53,2011,1919,35,28,29,731,716,15,28
3.9049E+11,3100,2580,230,100,190,158,1178,1110,68,1423,1273,79,30,41,556,492,64,22
3.9049E+11,1946,1796,58,19,73,83,820,764,56,2173,2072,40,31,30,843,803,40,19
3.9049E+11,1216,1050,74,25,67,39,524,494,30,1242,1119,70,25,28,513,491,22,24
3.9049E+11,2851,2429,239,47,136,101,1056,994,62,2366,2194,78,34,60,868,832,36,20
3.9049E+11,1350,629,677,1,43,56,0,0,0,116,75,36,0,5,3,3,0,2
3.9049E+11,1050,981,15,13,41,23,528,489,39,1088,1053,11,6,18,525,510,15,9
3.9049E+11,1203,1161,5,17,20,9,500,482,18,1311,1291,0,11,9,505,499,6,13
3.9049E+11,709,668,21,13,7,15,427,388,39,767,741,7,16,3,410,391,19,4
3.9049E+11,676,631,15,10,20,30,362,347,15,724,686,19,8,11,408,399,9,8
3.9049E+11,1106,1021,20,13,52,33,519,496,23,1014,974,11,12,17,468,446,22,13
3.9049E+11,789,757,8,10,14,14,361,347,14,771,730,11,9,21,348,340,8,20
3.9049E+11,677,656,8,7,6,12,316,298,18,665,635,12,4,14,284,278,6,13
3.9049E+11,1032,975,19,10,28,33,496,465,31,1122,1053,26,17,26,496,481,15,25
3.9049E+11,705,197,470,5,33,21,318,275,43,661,222,417,11,11,311,292,19,1
3.9049E+11,680,55,580,28,17,1,284,267,17,717,81,603,14,19,280,263,17,4
3.9049E+11,569,74,469,10,16,15,292,233,59,639,70,524,17,28,295,264,31,8
3.9049E+11,737,49,628,21,39,8,315,288,27,762,91,607,35,29,346,307,39,9
3.9049E+11,818,209,477,94,38,15,477,449,28,943,378,462,77,26,522,512,10,6
3.9049E+11,553,352,130,33,38,10,274,224,50,645,490,115,24,16,296,264,32,19
3.9049E+11,1227,534,395,52,246,273,505,476,29,1169,760,308,45,56,520,492,28,42
3.9049E+11,861,160,555,48,98,115,439,316,123,983,169,713,44,57,452,373,79,37
3.9049E+11,1009,185,722,3,99,107,461,418,43,833,186,607,6,34,448,345,103,14
3.9049E+11,752,358,336,2,56,50,669,70,599,1226,392,745,10,79,713,385,328,44
3.9049E+11,924,668,216,1,39,21,407,336,71,926,643,256,4,23,405,355,50,11
3.9049E+11,949,914,12,3,20,11,388,367,21,1006,967,14,2,23,401,388,13,11
3.9049E+11,1941,591,1206,8,136,47,852,785,67,1745,540,1138,16,51,713,667,46,12
3.9049E+11,1093,244,790,7,52,30,513,452,61,1340,305,960,6,69,517,499,18,35
3.9049E+11,895,65,789,0,41,14,346,327,19,895,50,826,0,19,343,327,16,7
3.9049E+11,847,166,656,12,13,14,377,343,34,821,156,637,5,23,375,343,32,10
3.9049E+11,584,76,462,3,43,13,267,245,22,680,87,563,3,27,267,248,19,6
3.9049E+11,989,916,20,8,45,28,420,392,28,915,890,4,7,14,381,368,13,6
3.9049E+11,919,869,12,9,29,17,437,391,46,980,948,14,4,14,440,398,42,5
3.9049E+11,787,756,16,0,15,9,349,325,24,815,807,0,1,7,357,347,10,2
3.9049E+11,2265,1514,630,33,88,40,1077,999,78,2471,1736,623,33,79,1072,1019,53,37
3.9049E+11,1751,1267,367,4,113,79,741,647,94,1331,1082,204,3,42,655,554,101,10
3.9049E+11,1354,1182,100,20,52,21,494,453,41,1213,1145,34,11,23,421,407,14,13
3.9049E+11,1225,1129,60,5,31,15,469,445,24,1287,1222,42,5,18,468,457,11,5
3.9049E+11,2550,2085,329,38,98,57,903,866,37,2707,2313,281,42,71,906,880,26,28
3.9049E+11,1167,1106,26,3,32,15,504,478,26,1214,1163,20,9,22,497,482,15,4
3.9049E+11,1402,1282,60,24,36,27,554,542,12,1389,1339,22,16,12,549,534,15,4
3.9049E+11,767,673,45,28,21,15,313,301,12,775,722,19,13,21,309,303,6,9
3.9049E+11,604,573,11,6,14,11,250,239,11,637,612,20,1,4,251,243,8,2
3.9049E+11,2290,1874,291,25,100,50,676,569,107,2269,1894,247,40,88,665,581,84,20
3.9049E+11,1220,1145,30,25,20,16,587,491,96,1215,1159,29,10,17,560,493,67,14
3.9049E+11,1323,1178,85,24,36,15,565,522,43,1379,1245,98,13,23,609,555,54,4
3.9049E+11,714,681,10,9,14,9,239,234,5,723,693,1,12,17,242,238,4,9
3.9049E+11,1147,941,135,12,59,46,487,451,36,1242,1063,141,8,30,489,479,10,12
3.9049E+11,976,889,41,20,26,6,384,367,17,1012,963,14,6,29,382,375,7,13
3.9049E+11,752,717,16,4,15,7,268,259,9,776,761,7,4,4,266,260,6,11
3.9049E+11,926,875,12,15,24,14,354,333,21,903,871,17,6,9,308,304,4,12
3.9049E+11,936,877,35,5,19,18,364,353,11,933,893,18,8,14,363,351,12,13
3.9049E+11,2776,1162,1215,154,245,294,1724,1513,211,1797,1257,279,200,61,1146,1026,120,31
3.9049E+11,1348,464,632,18,234,291,969,713,256,1575,912,535,25,103,988,865,123,78
3.9049E+11,589,241,263,14,71,47,317,176,141,863,286,514,22,41,321,274,47,22
3.9049E+11,1087,743,242,16,86,80,517,459,58,1147,977,99,6,65,521,494,27,37
3.9049E+11,1285,965,178,14,128,147,579,520,59,1409,1260,92,24,33,690,608,82,13
3.9049E+11,1196,597,434,19,146,149,714,571,143,1319,908,286,40,85,711,641,70,78
3.9049E+11,1165,795,203,43,124,122,518,406,112,1242,1066,105,20,51,517,465,52,38
3.9049E+11,977,660,232,21,64,76,411,375,36,947,820,65,34,28,413,402,11,7
3.9049E+11,1091,570,401,25,95,76,461,424,37,1153,757,309,28,59,489,470,19,21
3.9049E+11,643,529,75,1,38,46,271,249,22,664,641,7,7,9,274,270,4,3
3.9049E+11,1276,1046,117,7,106,101,564,516,48,1339,1251,26,24,38,561,547,14,15
3.9049E+11,602,468,67,0,67,60,256,228,28,621,560,40,7,14,260,248,12,8
3.9049E+11,692,534,92,16,50,41,312,287,25,706,636,42,13,15,329,304,25,12
3.9049E+11,595,372,184,9,30,10,240,222,18,629,487,95,23,24,261,252,9,4
3.9049E+11,1035,511,471,19,34,43,427,402,25,1034,768,209,16,41,429,421,8,12
3.9049E+11,955,381,497,5,72,75,401,372,29,942,575,316,16,35,402,387,15,21
3.9049E+11,889,246,525,9,109,93,496,400,96,870,439,359,33,39,496,456,40,21
3.9049E+11,785,318,399,16,52,39,334,297,37,1524,823,590,29,82,711,677,34,22
3.9049E+11,520,145,310,3,62,44,436,241,195,225,63,152,0,10,91,87,4,2
3.9049E+11,910,288,530,15,77,56,419,373,46,849,516,280,11,42,383,363,20,18
3.9049E+11,781,156,532,4,89,72,343,317,26,752,415,274,5,58,350,322,28,31
3.9049E+11,795,273,431,45,46,34,351,323,28,710,456,214,27,13,338,332,6,5
3.9049E+11,768,329,329,14,96,98,341,312,29,748,467,221,34,26,338,323,15,15
3.9049E+11,601,287,250,16,48,37,259,239,20,605,386,157,36,26,260,253,7,7
3.9049E+11,859,483,294,9,73,62,414,381,33,905,729,143,5,28,401,390,11,23
3.9049E+11,1469,536,822,38,73,39,603,557,46,1506,864,545,35,62,608,598,10,16
3.9049E+11,877,235,564,16,62,71,429,347,82,971,410,453,66,42,415,398,17,24
3.9049E+11,693,302,347,11,33,38,306,269,37,703,468,206,10,19,305,295,10,9
3.9049E+11,807,157,584,10,56,41,454,392,62,1001,292,648,20,41,497,454,43,24
3.9049E+11,1149,153,680,10,306,292,410,359,51,1261,235,948,4,74,463,441,22,46
3.9049E+11,583,113,448,5,17,27,302,223,79,718,213,456,7,42,304,288,16,8
3.9049E+11,748,231,424,19,74,58,635,501,134,996,586,363,12,35,695,642,53,30
3.9049E+11,1032,279,664,9,80,119,527,478,49,884,371,474,13,26,546,516,30,21
3.9049E+11,2818,343,2064,43,368,356,1219,1099,120,2212,547,1427,44,194,1093,997,96,227
3.9049E+11,1747,532,1053,11,151,155,999,887,112,1795,851,801,27,116,984,957,27,42
3.9049E+11,803,120,629,9,45,40,689,362,327,1441,282,1000,18,141,826,687,139,115
3.9049E+11,638,72,547,1,18,5,307,279,28,644,132,473,2,37,308,291,17,14
3.9049E+11,594,52,524,0,18,3,272,249,23,617,69,515,5,28,263,254,9,2
3.9049E+11,854,54,751,5,44,8,374,354,20,1016,103,879,5,29,411,406,5,6
3.9049E+11,1014,366,582,20,46,36,557,534,23,567,193,358,7,9,233,232,1,0
3.9049E+11,1207,199,867,81,60,38,520,481,39,1053,250,683,68,52,432,413,19,46
3.9049E+11,852,152,628,19,53,28,478,448,30,966,252,641,36,37,490,487,3,7
3.9049E+11,841,148,611,48,34,24,360,334,26,943,265,589,54,35,396,376,20,17
3.9049E+11,838,139,627,36,36,14,353,327,26,1069,295,715,29,30,433,414,19,13
3.9049E+11,1131,107,946,18,60,32,546,442,104,1291,154,1066,18,53,550,487,63,17
3.9049E+11,1739,571,1033,12,123,68,861,813,48,1560,660,816,18,66,859,774,85,30
3.9049E+11,999,584,327,41,47,25,683,663,20,995,693,213,62,27,691,657,34,15
3.9049E+11,1088,216,786,7,79,54,449,397,52,1117,278,749,23,67,441,408,33,18
3.9049E+11,1111,172,855,25,59,32,440,389,51,1206,290,826,24,66,442,432,10,30
3.9049E+11,730,109,568,7,46,40,350,274,76,750,150,566,20,14,321,278,43,9
3.9049E+11,928,88,731,17,92,103,435,408,27,898,284,517,31,66,441,414,27,37
3.9049E+11,1432,759,509,13,151,127,580,529,51,1420,1090,255,33,42,581,544,37,34
3.9049E+11,1384,702,480,25,177,112,753,645,108,1443,999,324,20,100,747,712,35,81
3.9049E+11,1768,786,710,30,242,242,849,767,82,1714,999,573,45,97,858,806,52,59
3.9049E+11,932,383,470,6,73,57,474,435,39,1010,636,311,26,37,476,441,35,56
3.9049E+11,1331,771,493,8,59,37,698,646,52,911,681,181,24,25,442,406,36,25
3.9049E+11,722,300,370,14,38,22,382,353,29,686,471,176,15,24,370,359,11,7
3.9049E+11,1514,1009,452,14,39,21,885,817,68,1338,1096,210,19,13,660,614,46,13
3.9049E+11,1203,367,740,24,72,47,709,639,70,1210,721,370,74,45,713,675,38,31
3.9049E+11,1596,1155,372,39,30,25,708,681,27,1881,1504,290,55,32,767,757,10,25
3.9049E+11,997,675,271,7,44,33,485,447,38,900,740,136,3,21,438,414,24,12
3.9049E+11,985,789,164,8,24,29,415,386,29,1077,953,105,5,14,437,430,7,4
3.9049E+11,833,707,102,3,21,21,326,311,15,761,670,61,13,17,284,282,2,7
3.9049E+11,2025,1386,515,47,77,63,1004,925,79,1955,1552,257,80,66,898,862,36,55
3.9049E+11,1627,785,724,17,101,40,851,790,61,1575,1067,418,26,64,834,789,45,21
3.9049E+11,1064,346,621,14,83,85,695,676,19,867,526,223,50,68,689,526,163,64
3.9049E+11,1183,476,620,19,68,34,546,488,58,1144,817,284,23,20,560,528,32,14
3.9049E+11,1654,319,1235,6,94,54,885,714,171,1762,787,840,13,122,852,755,97,74
3.9049E+11,634,263,335,12,24,18,279,260,19,681,481,169,5,26,279,276,3,12
3.9049E+11,798,338,397,24,39,17,328,297,31,818,551,218,21,28,331,326,5,11
3.9049E+11,832,384,401,12,35,40,348,320,28,921,656,211,13,41,349,344,5,32
3.9049E+11,2042,563,1332,38,109,87,744,701,43,2158,984,1017,35,122,735,719,16,41
3.9049E+11,2853,303,2337,30,183,114,962,887,75,626,233,344,14,35,228,226,2,4
3.9049E+11,973,540,340,13,80,42,438,346,92,1131,910,185,6,30,461,409,52,20
3.9049E+11,981,393,509,7,72,47,370,342,28,1069,695,303,35,36,366,359,7,14
3.9049E+11,966,460,417,30,59,28,395,372,23,947,651,241,20,35,365,354,11,17
3.9049E+11,1919,827,888,35,169,127,865,758,107,2247,1495,547,84,121,934,892,42,83
3.9049E+11,4315,1745,2188,58,324,227,2057,1894,163,2462,1711,586,62,103,1090,1038,52,90
3.9049E+11,1822,983,682,46,111,81,693,653,40,2190,1663,436,38,53,762,738,24,33
3.9049E+11,986,729,208,14,35,25,621,482,139,1147,964,128,22,33,613,552,61,24
3.9049E+11,1123,892,180,23,28,16,404,387,17,1249,1135,65,25,24,456,449,7,4
3.9049E+11,2265,1139,908,80,138,90,1025,963,62,2272,1521,573,78,100,1040,948,92,81
3.9049E+11,1065,534,451,5,75,57,506,449,57,1101,821,197,17,66,487,452,35,54
3.9049E+11,1676,1319,260,21,76,57,850,799,51,1784,1617,95,20,52,866,826,40,24
3.9049E+11,1127,1020,42,11,54,28,509,471,38,1244,1195,19,9,21,510,496,14,8
3.9049E+11,876,704,84,7,81,29,404,381,23,965,900,39,2,24,454,431,23,9
3.9049E+11,1397,906,399,19,73,73,710,635,75,1452,1257,145,21,29,710,680,30,21
3.9049E+11,1582,982,449,14,137,83,708,659,49,1534,1313,140,19,62,710,683,27,29
3.9049E+11,1013,846,133,9,25,38,539,503,36,970,900,40,10,20,499,471,28,7
3.9049E+11,1415,1198,162,5,50,37,598,570,28,1494,1372,80,20,22,611,579,32,23
3.9049E+11,2026,1442,439,74,71,64,1091,1011,80,1916,1689,138,57,32,872,847,25,21
3.9049E+11,2750,1151,1336,15,248,176,1282,1055,227,1917,1370,428,25,94,798,729,69,68
3.9049E+11,14,1,13,0,0,0,5,4,1,1063,782,192,17,72,507,481,26,43
3.9049E+11,2315,1772,389,54,100,46,907,852,55,2018,1772,169,38,39,747,724,23,12
3.9049E+11,3094,2345,516,77,156,126,1280,1213,67,2241,2064,117,11,49,940,898,42,38
3.9049E+11,1123,819,209,18,77,49,456,425,31,1290,1084,136,29,41,517,493,24,28
3.9049E+11,1751,1052,558,31,110,60,624,590,34,1700,1295,324,19,62,590,568,22,21
3.9049E+11,973,795,121,5,52,43,357,330,27,1154,1034,84,5,31,383,375,8,22
3.9049E+11,1437,1140,210,9,78,38,531,499,32,1569,1389,105,15,60,530,517,13,12
3.9049E+11,1190,975,164,13,38,22,436,402,34,1316,1220,60,5,31,434,428,6,14
3.9049E+11,2193,1216,826,59,92,61,1112,875,237,2169,1591,402,45,131,1049,909,140,48
3.9049E+11,650,563,66,12,9,13,278,269,9,629,567,32,17,13,268,263,5,10
3.9049E+11,766,535,170,21,40,29,401,358,43,245,223,7,1,14,103,94,9,2
3.9049E+11,1968,1458,392,28,90,35,687,663,24,1777,1453,229,45,50,623,592,31,23
3.9049E+11,2454,1448,825,47,134,110,1022,954,68,1095,910,115,39,31,430,419,11,13
3.9049E+11,1490,478,873,30,109,36,623,600,23,1464,736,635,29,64,619,593,26,9
3.9049E+11,1397,1303,49,7,38,34,695,609,86,1601,1517,22,4,58,697,667,30,28
3.9049E+11,1769,1651,40,5,73,42,756,706,50,1506,1465,7,12,22,633,598,35,16
3.9049E+11,1219,744,354,69,52,35,429,382,47,233,226,2,5,0,93,90,3,5
3.9049E+11,4111,3711,261,54,85,56,1620,1536,84,2676,2543,70,20,43,1056,995,61,22
3.9049E+11,2017,1866,79,26,46,21,892,774,118,1370,1308,26,11,25,553,505,48,1
3.9049E+11,2736,1808,710,40,178,60,933,854,79,1757,1491,200,9,57,621,595,26,24
3.9049E+11,1157,879,140,53,85,72,467,413,54,988,929,28,0,31,391,371,20,30
3.9049E+11,2797,1860,722,47,168,78,1124,1037,87,2357,1799,420,41,97,907,828,79,47
3.9049E+11,889,696,143,27,23,11,396,388,8,724,590,104,19,11,308,285,23,12
3.9049E+11,1625,1546,23,26,30,14,692,646,46,1763,1712,16,8,27,671,661,10,24
3.9049E+11,1624,1397,149,22,56,40,631,594,37,711,692,8,0,11,308,293,15,9
3.9049E+11,1141,1036,66,4,35,18,447,411,36,1111,1001,62,12,36,447,421,26,9
3.9049E+11,1543,1307,148,30,58,25,595,560,35,1632,1496,75,3,58,597,583,14,19
3.9049E+11,762,738,3,8,13,13,306,286,20,805,779,7,7,12,311,300,11,8
3.9049E+11,1387,1339,12,4,32,19,537,519,18,1419,1380,2,14,23,538,529,9,12
3.9049E+11,1397,1345,13,9,30,10,703,653,50,1321,1296,5,8,12,637,610,27,10
3.9049E+11,1186,888,223,14,61,42,487,438,49,746,734,4,1,7,288,269,19,2
3.9049E+11,970,262,529,112,67,38,370,340,30,913,245,507,122,39,362,336,26,12
3.9049E+11,975,902,21,9,43,54,479,454,25,1068,1039,11,2,16,490,458,32,17
3.9049E+11,892,842,16,1,33,12,429,395,34,967,954,3,0,10,439,419,20,7
3.9049E+11,1332,1218,36,12,66,52,584,546,38,1371,1327,14,6,24,593,549,44,20
3.9049E+11,1291,1185,55,14,37,27,519,490,29,1385,1355,12,3,15,508,492,16,9
3.9049E+11,1155,1110,25,2,18,28,410,389,21,1224,1184,5,3,32,411,400,11,21
3.9049E+11,804,660,79,15,50,24,419,383,36,913,855,24,1,33,436,399,37,23
3.9049E+11,1102,1053,10,5,34,12,479,452,27,1130,1091,15,11,13,464,451,13,7
3.9049E+11,624,609,1,2,12,14,277,269,8,650,647,0,0,3,276,270,6,8
3.9049E+11,623,601,4,2,16,8,271,262,9,621,612,4,2,3,272,268,4,0
3.9049E+11,1276,1198,29,4,45,22,597,559,38,1299,1257,11,4,27,604,581,23,14
3.9049E+11,1552,1352,103,28,69,39,727,693,34,1397,1312,41,9,35,632,578,54,17
3.9049E+11,2154,2077,22,21,34,32,971,928,43,1952,1918,16,3,15,806,781,25,18
3.9049E+11,915,887,1,6,21,16,357,346,11,861,856,2,0,3,320,316,4,5
3.9049E+11,2189,1863,77,28,221,218,1120,1046,74,2078,1973,40,18,47,1012,960,52,39
3.9049E+11,3650,3485,42,28,95,52,1430,1380,50,2663,2586,17,20,40,992,960,32,28
3.9049E+11,5310,4900,144,134,132,110,2336,2165,171,1770,1689,41,23,17,671,641,30,31
3.9049E+11,1553,1477,37,23,16,31,577,545,32,1111,1088,1,6,16,397,389,8,9
3.9049E+11,3070,2925,54,37,54,49,1023,998,25,2496,2416,41,18,21,805,792,13,19
3.9049E+11,5032,4733,128,70,101,45,1831,1738,93,2840,2730,54,13,43,990,966,24,11
3.9049E+11,3037,2591,194,63,189,112,1114,1046,68,1215,1142,36,17,20,507,427,80,9
3.9049E+11,3087,2807,117,63,100,97,1082,1046,36,2814,2632,73,31,78,943,909,34,36
3.9049E+11,2243,2174,22,4,43,42,922,844,78,2237,2188,8,7,34,853,818,35,6
3.9049E+11,1263,1215,8,14,26,6,521,496,25,1322,1294,5,6,17,507,483,24,8
3.9049E+11,1762,1693,14,9,46,20,738,688,50,2096,2057,9,10,20,795,773,22,7
3.9049E+11,1477,1432,19,4,22,11,522,506,16,1326,1302,8,5,11,474,465,9,8
3.9049E+11,1499,683,561,55,200,217,1016,881,135,1300,1026,160,63,51,909,807,102,37
3.9049E+11,477,451,8,4,14,12,202,190,12,580,559,6,6,9,222,213,9,0
3.9049E+11,297,280,5,3,9,9,217,202,15,208,201,2,0,5,118,115,3,1
3.9049E+11,823,664,101,33,25,13,369,357,12,1590,1381,113,67,29,673,638,35,11
3.9049E+11,2142,1694,289,55,104,54,1225,1108,117,1533,1336,114,47,36,921,868,53,31
3.9049E+11,1649,1256,234,93,66,53,796,739,57,1279,1115,84,46,34,674,623,51,19
3.9049E+11,1020,412,528,38,42,35,738,553,185,504,122,371,1,10,215,206,9,6
3.9049E+11,7543,4700,2216,120,507,340,3438,3104,334,1991,1607,304,11,69,963,894,69,37
3.9049E+11,4277,2190,1753,92,242,183,1867,1656,211,1834,1281,415,20,118,724,665,59,35
3.9049E+11,2636,1235,1160,22,219,167,1422,1186,236,1454,1154,206,22,72,678,620,58,48
3.9049E+11,1464,1164,221,38,41,36,1085,966,119,875,800,56,7,12,715,555,160,16
3.9049E+11,2801,2180,406,21,194,115,1014,883,131,2871,2354,391,21,105,1035,929,106,38
3.9049E+11,3173,2420,27,645,81,60,1098,1063,35,2300,2065,27,166,42,840,796,44,20
3.9049E+11,2291,1824,26,382,59,75,766,745,21,1330,1201,21,103,5,470,445,25,9
3.9049E+11,2035,1669,42,280,44,36,660,648,12,1239,1087,38,95,19,367,358,9,17
3.9049E+11,1320,1143,24,120,33,26,449,444,5,1158,1088,14,49,7,374,368,6,7
3.9049E+11,2455,2191,12,217,35,33,883,861,22,2775,2513,24,219,19,829,822,7,33
3.9049E+11,2374,1680,20,618,56,57,984,907,77,2039,1805,35,166,33,921,824,97,32
3.9049E+11,1804,1485,52,225,42,29,816,771,45,2246,1903,50,258,35,1038,909,129,18
3.9049E+11,1176,1013,22,120,21,34,352,346,6,433,406,1,22,4,145,141,4,7
3.9049E+11,3468,2920,106,333,109,102,1105,1080,25,1168,1095,15,31,27,417,396,21,32
3.9049E+11,1510,1369,48,41,52,53,920,864,56,1552,1393,33,64,62,893,796,97,34
3.9049E+11,2574,2293,59,159,63,55,854,834,20,2467,2225,52,136,54,795,777,18,48
3.9049E+11,2155,1824,50,220,61,31,689,672,17,2469,2211,37,132,89,911,859,52,42
3.9049E+11,1299,1062,119,62,56,34,912,815,97,1318,1094,84,97,43,883,818,65,36
3.905E+11,2,2,0,0,0,0,1,1,0,36,32,3,0,1,17,16,1,0
3.91591E+11,1454,1430,5,5,14,17,581,534,47,1281,1261,3,0,17,465,446,19,12
3.91591E+11,1255,1243,0,2,10,1,492,455,37,1208,1186,8,0,14,429,410,19,7
3.91591E+11,1178,1163,5,2,8,10,509,445,64,1146,1130,2,2,12,502,453,49,5
3.91591E+11,1438,1388,12,10,28,8,551,521,30,1251,1229,4,5,13,443,430,13,10
3.91591E+11,880,868,3,4,5,5,340,316,24,825,816,3,1,5,299,290,9,9
3.91591E+11,1610,1584,5,0,21,9,680,636,44,1572,1542,5,0,25,660,595,65,3
3.91591E+11,782,760,2,3,17,4,330,299,31,811,788,5,2,16,311,297,14,2
3.91591E+11,1455,1425,2,4,24,8,518,498,20,1120,1091,6,4,19,398,383,15,7
3.91591E+11,2430,2365,10,20,35,31,864,819,45,1967,1931,8,16,12,716,674,42,10
3.91591E+11,1511,1358,54,20,79,35,500,477,23,935,880,24,4,27,274,264,10,7
3.91591E+11,5137,4810,45,152,130,77,1635,1553,82,2131,2006,22,49,54,704,686,18,32
3.91591E+11,1097,1065,5,10,17,4,428,403,25,1111,1099,4,0,8,389,376,13,5
3.91591E+11,1249,1207,10,4,28,17,517,464,53,1324,1290,3,5,26,516,482,34,15
3.91591E+11,2063,1939,26,30,68,34,808,769,39,2085,2018,21,25,21,793,755,38,23
3.91591E+11,1708,1610,21,19,58,68,756,678,78,1786,1754,4,7,21,764,722,42,15
3.91591E+11,2972,2844,24,51,53,35,1219,1127,92,1991,1921,6,35,29,873,815,58,32
3.91591E+11,2597,1799,783,11,4,21,1,1,0,1758,859,874,1,24,1,1,0,15
3.91591E+11,1396,1338,9,6,43,42,621,525,96,1730,1697,2,6,25,713,670,43,12
3.91591E+11,1856,1726,25,33,72,38,926,876,50,1526,1453,18,17,38,751,717,34,24
3.91591E+11,545,538,1,2,4,10,267,207,60,693,667,12,5,9,289,266,23,1
3.91591E+11,1481,1393,20,24,44,9,733,665,68,1126,1115,2,2,7,462,438,24,10
3.91591E+11,825,802,9,5,9,9,352,314,38,863,843,10,1,9,328,315,13,10
3.91591E+11,1116,1042,42,14,18,10,441,406,35,1124,1054,56,4,10,423,398,25,3
3.91591E+11,2931,2056,43,766,66,58,898,841,57,231,221,0,2,8,84,80,4,7
3.91591E+11,2227,1971,18,187,51,24,1061,974,87,1936,1859,21,19,37,904,762,142,3
3.91591E+11,1718,1669,4,9,36,16,661,638,23,1644,1615,6,1,22,596,584,12,10
3.91591E+11,1075,1050,6,8,11,8,420,401,19,1180,1164,7,0,9,492,454,38,5
3.91591E+11,1426,1388,7,13,18,18,546,525,21,1323,1310,1,5,7,467,454,13,6
3.91591E+11,2373,2303,17,11,42,18,900,851,49,1888,1848,5,5,30,705,668,37,5
3.91591E+11,2515,2453,18,22,22,17,874,847,27,1376,1349,8,5,14,495,481,14,5